fips,adult_pop,female_pop,male_pop,median_age,population,pct_poverty,median_income,pct_highschool,pct_unemployed
1001,41890,28422,26994,38.6,55416,13.5,54487,87.6,3.4
1003,163233,107322,101241,42.9,208563,11.7,56460,90,3.7
1005,20477,12186,13779,40.1,25965,29.9,32884,73.8,6.2
1007,17944,10498,12145,39.6,22643,20.1,43079,80.7,3.5
1009,44322,29206,28498,41.1,57704,14.1,47213,80,3
1011,8155,4762,5600,39.4,10362,32.6,34278,66.6,7.5
1013,15284,10676,9322,40.6,19998,24.8,35409,81.1,5.3
1015,89591,59473,55138,39.8,114611,17.1,41778,82.3,6.7
1017,26670,17600,16243,42.6,33843,19.9,39530,80.3,4.1
1019,20625,12956,12769,46.2,25725,16.8,41456,81.3,3
1021,33378,22336,21605,39.4,43941,18.3,44188,80.1,4.4
1023,10356,6813,6180,45.7,12993,22.7,32691,78.9,6.2
1025,19039,12853,11539,42.3,24392,29,34061,81,8.4
1027,10690,6876,6616,44.1,13492,18.9,38512,74.6,3.5
1029,11478,7503,7421,42.3,14924,17.2,43483,74.2,3.8
1031,39062,25907,25319,39.3,51226,14.4,48632,85.1,3.5
1033,42724,28058,26158,42.6,54216,16.7,46572,83.4,4.1
1035,9778,6434,5961,44.5,12395,28.1,29758,79.4,9.6
1037,8728,5212,5369,47.2,10581,17.5,36441,72.9,5.9
1039,29229,19385,18073,43.2,37458,19.6,35010,80.9,5.7
1041,10706,7119,6794,41.7,13913,20.5,37374,78.3,4.1
1043,63929,41740,40731,41,82471,14.9,41543,82.2,3.2
1045,37850,24962,24264,37.9,49226,20.6,40523,85.8,5.5
1047,30154,21528,18480,38.8,40008,35.4,30488,79,7.8
1049,53560,35814,35086,39.3,70900,20.5,37128,72.6,3.4
1051,63338,42134,39665,38.6,81799,13.5,54553,86.8,4.2
1053,29359,18344,19384,39.9,37728,23.3,35096,80.5,7.1
1055,80238,52918,49646,41.7,102564,17.5,40972,82.5,4.6
1057,13043,8367,8179,43.8,16546,20.3,38403,79.2,4.4
1059,23924,15835,15793,38.8,31628,20.1,37049,75.7,5.4
1061,20736,13546,13068,43.3,26614,20.9,36976,77.7,5.5
1063,6513,4421,4001,42.2,8422,34,26559,76.9,7.7
1065,11394,7892,7060,40.5,14952,23.7,35381,81.4,5.7
1067,13592,8860,8304,44.4,17164,18.7,41426,80.7,4.1
1069,79685,54194,49862,39.6,104056,19.4,42910,84.9,4.7
1071,41102,26480,25658,43.4,52138,17.5,41407,79.5,4.6
1073,507704,347409,312112,37.7,659521,15.3,50109,89,5.1
1075,10948,7136,6782,44.4,13918,18.6,38358,77.4,4.7
1077,73777,48185,44133,41.4,92318,15.2,44124,84.9,4.3
1079,25985,17017,16227,42.5,33244,16.8,43107,77.5,4.3
1081,124914,80598,78393,31.3,158991,18.3,47749,88.7,3.7
1083,71383,46275,46478,39.6,92753,12.8,52181,83.2,4.6
1085,8015,5463,4895,41.6,10358,31.7,32011,74.8,6
1087,15675,10318,8645,38.6,18963,30,30681,80.5,8.1
1089,278157,182725,174242,38.5,356967,13.5,61193,90.8,4.7
1091,15201,10374,9299,42,19673,25.8,34794,83.9,6.8
1093,23671,15098,14900,44,29998,18.5,36386,79.9,4
1095,71645,48230,46927,39,95157,21,42117,78.6,4
1097,316518,216639,198197,37.5,414836,19.5,45233,85.8,5
1099,16645,11262,10268,42.3,21530,25.7,36639,82,10.4
1101,173781,119329,107020,36.4,226349,18.8,45111,85.5,5.2
1103,91776,60456,58556,40.5,119012,15.8,46843,82.5,5.2
1105,7509,5065,4509,37.7,9574,35,25221,76.4,4.3
1107,16275,10168,10156,41.9,20324,25.8,35968,81.1,5.9
1109,26901,17378,15908,31.1,33286,25.1,35172,80,5.7
1111,17690,11657,10995,43.4,22652,21.8,40283,77.3,4
1113,43597,29997,28175,35.9,58172,19.3,38617,82.6,5.4
1115,67938,44070,43949,40.1,88019,12,57856,83.5,3.8
1117,160133,108441,102181,38.8,210622,7.9,74212,91.6,3.1
1119,10460,7103,5937,36.5,13040,32.4,26814,80,7.2
1121,62697,41325,38778,41.2,80103,18,40555,79.8,6.5
1123,32157,20923,19804,44.5,40727,20.2,40169,79.6,5
1125,162931,106829,99273,32.7,206102,17.6,47483,88.1,4.1
1127,50570,33251,31716,42.3,64967,20.5,39511,78.6,5.6
1129,12902,8547,8209,41.7,16756,18.2,37575,79.7,8
1131,8301,5758,5228,40.3,10986,31.9,24216,79.9,8.4
1133,18845,12056,11749,45,23805,17.3,38644,76,4.4
2000,,,,,,,,,
2013,3003,1060,2236,42.3,3296,14.8,63991,84.4,2.3
2016,4989,1863,3784,41.7,5647,8,78151,87.5,0.9
2020,224225,146093,152099,33.3,298192,7.2,83959,93.3,4.2
2050,11513,8687,9281,26.9,17968,25.5,46634,80.9,11.9
2060,726,413,485,40.9,898,11.4,68026,92.6,4.2
2068,1599,888,1065,40.7,1953,6.3,72378,96.2,0.9
2070,3394,2434,2520,29.5,4954,19.6,52250,86.8,6.9
2090,76087,46194,54411,30.7,100605,8.5,73427,94.4,5.6
2100,2046,1263,1233,48.7,2496,10.3,53471,95.5,2.5
2105,1672,995,1083,47.8,2078,19.1,53884,90.6,6.8
2110,25340,15946,16522,37.5,32468,7.4,82011,95.6,3.6
2122,45173,27870,30636,40.5,58506,12,68501,92.7,5.3
2130,10687,6657,7089,39.7,13746,9.2,67125,92,5.1
2150,10129,6443,7289,34,13732,7.3,74683,90.7,2.6
2164,1118,752,810,32.7,1562,20.9,44310,86.3,7.9
2170,76002,49795,54570,34.8,104365,9.5,71793,92.4,6.2
2180,6412,4710,5207,27.7,9917,24,55974,84.9,11.1
2185,7110,3608,5998,34.5,9606,11.9,74998,88.4,8
2188,4924,3518,4155,26.8,7673,27.8,53692,79.1,14.2
2195,2438,1488,1661,39.9,3149,8.4,60540,92.4,4
2198,4811,2884,3463,40,6347,17.5,48888,90.5,8.8
2220,6863,4277,4553,38.9,8830,7.9,72795,92.6,3.1
2230,933,524,564,39.6,1088,4.4,65112,96.5,5.6
2240,5108,3069,3807,37.2,6876,11.8,59412,90.7,5.9
2261,7120,4481,4874,38.7,9355,9.2,69755,92.8,6
2270,,,,,,,,,
2275,1910,1166,1245,47.5,2411,11.5,56747,88.1,4.3
2282,480,263,338,41.5,601,16.8,57687,94.5,5.4
2290,3994,2573,2953,35.5,5526,23,37906,82.9,11.2
4001,52072,37159,35953,34.3,73112,33.2,34040,78.2,6.4
4003,98064,61641,64129,41.1,125770,21.1,45151,86.6,3.9
4005,111071,71462,69446,31,140908,17.8,53643,88.9,5.3
4007,42625,26983,26573,49.9,53556,20.3,40747,84.3,5.7
4009,27105,17457,20142,32.7,37599,22.9,46714,85.4,7.2
4011,6894,4646,4967,33.6,9613,12,61110,87.9,5
4012,16814,9957,10360,55.9,20317,24.8,34285,75.2,4.4
4013,3202884,2145005,2097992,36.3,4242997,15,58742,86.9,4.3
4015,168411,101898,103351,51.1,205249,18.3,42003,83.9,5.2
4017,79959,54818,55208,36.7,110026,28.2,37440,81.5,9
4019,798710,516727,499479,38.7,1016206,18.2,47644,87.7,5.4
4021,320383,201176,217364,39.3,418540,15.4,52642,84.9,4.7
4023,33273,24002,21983,37,45985,20.9,39090,74.8,5.4
4025,187886,115491,110071,53.3,225562,13.3,49824,90.2,4.2
4027,153428,99754,105877,34.6,205631,19.3,42998,71.7,6.6
5001,14046,9427,8787,41.6,18214,18.1,39726,82.5,5.5
5003,15723,10519,9973,42.3,20492,17.9,41277,83.9,5.4
5005,33778,21172,19890,52.1,41062,12.7,40147,87.2,2.9
5007,189336,130195,128096,35.4,258291,9.1,64072,87.2,2.2
5009,28929,18905,18399,42.3,37304,15.4,39881,85,4.7
5011,8370,5628,5368,40.8,10996,23.5,34114,79.9,5.7
5013,4200,2546,2598,46.3,5144,17.1,33507,83.2,3.8
5015,21561,14041,13605,44.7,27646,17.2,37145,83.8,3.3
5017,8444,5513,5432,42.5,10945,30.1,29527,80.1,5
5019,18318,11892,10765,33.3,22657,22.3,37247,86.5,4.6
5021,11809,7616,7304,44,14920,19.1,36037,79.1,3.8
5023,20416,12795,12469,48.7,25264,16.3,42397,83.3,4.3
5025,6377,4191,4050,42.7,8241,15.8,45256,86.1,4.7
5027,18905,12357,11544,35.8,23901,24.2,35322,85.2,5.3
5029,16145,10654,10283,42,20937,18.9,41892,85,3.9
5031,79522,54308,51527,34.1,105835,16.2,44091,88,4
5033,46926,31559,30708,39.1,62267,16.8,42941,85.3,4
5035,35507,25744,23491,34.8,49235,25.5,37627,81.8,5.5
5037,12924,8808,8229,40.5,17037,19.4,40970,80.7,4.2
5039,5842,3811,3658,44.6,7469,20.8,33679,83.4,3.7
5041,8833,6281,5595,39.7,11876,26.5,32392,76.1,6.8
5043,14558,9609,9042,36.6,18651,19.2,40441,81.7,7.3
5045,93585,62397,59830,32.5,122227,16,50909,91.1,3.7
5047,13525,8830,8796,41,17626,17.9,40091,81.1,4.5
5049,9624,6113,6010,48.7,12123,23.2,33451,83.9,3.4
5051,77391,50514,46963,44.6,97477,17.8,42087,88.4,5
5053,13924,9082,9.00E+03,41,18082,11.5,54411,90,4.6
5055,33588,22636,21962,38,44598,15.3,45208,85.3,4.7
5057,16259,11368,10606,39.2,21974,20.7,38769,78.7,4.6
5059,26435,15926,17448,41.7,33374,14.7,46313,85.9,3.7
5061,9912,6931,6446,38.8,13377,18.7,36166,79.4,4.2
5063,28258,19047,18121,39.5,37168,15.9,42520,84.5,3.9
5065,11008,6448,6985,48.1,13433,20.1,36987,83.9,4.3
5067,13748,8700,8521,40.6,17221,24.1,35098,76.6,3.2
5069,54005,35357,34659,38.4,70016,23.3,38485,84.3,5.1
5071,19747,13145,13031,37.6,26176,18.4,37205,79,3.1
5073,5517,3534,3313,47.2,6847,27.4,32288,80.2,5.4
5075,13047,8488,8247,41.3,16735,20,39015,81.7,4.3
5077,7544,4059,5251,40.8,9310,35.9,26912,69.3,6.7
5079,11314,5254,8451,38.3,13705,27.6,35419,79.1,3.7
5081,9731,6403,6048,43.3,12451,17.5,43567,86,4.5
5083,16991,10958,10834,43.2,21792,18.2,39361,82.8,4.2
5085,53538,36600,35628,36.2,72228,12.4,56247,88.1,3.5
5087,12281,8033,8039,41.7,16072,18.3,39059,80.4,2.9
5089,13452,8269,8056,52.1,16325,20.7,33950,86,4.4
5091,33176,22193,21594,38.1,43787,22.4,38412,85.5,5.1
5093,31475,22003,20832,36.2,42835,24.6,35846,80.4,6.3
5095,5648,3814,3355,45.6,7169,27,32906,78.2,5.9
5097,7210,4463,4416,50.2,8879,22.4,36435,79.8,2.1
5099,6523,4223,4175,43.8,8398,20.4,37612,83.1,3.6
5101,6357,3921,4015,48.8,7936,19.9,33107,80.4,2.5
5103,18661,12665,11433,43.4,24098,24.7,36016,86.2,4.4
5105,7883,5122,5010,43.3,10132,16.9,43819,82.2,3.8
5107,13961,10011,8964,38.2,18975,32.3,29073,76.4,9.4
5109,8435,5429,5403,42.7,10832,18.2,34821,81.4,3.1
5111,18281,12378,11645,39.8,24023,22.7,36125,78.7,3.5
5113,15467,10271,9902,43.9,20173,23.4,32941,84.3,4.2
5115,49176,32064,31715,35.2,63779,17.5,42916,83.5,4.2
5117,6542,4139,4112,46.3,8251,17.8,40340,82.4,3.7
5119,300432,205137,188113,36.9,393250,17.2,47966,90.1,4
5121,13536,8801,8647,42.2,17448,18.9,38647,83.3,2.1
5123,20413,11824,14372,38.2,26196,31.6,39675,78,5.2
5125,90925,60523,58180,39.8,118703,8.7,63618,89.3,3
5127,7870,5038,5239,42.5,10277,19.7,34245,76.4,6.8
5129,6340,3952,4015,47.4,7967,23.1,29747,84.6,2
5131,96843,65340,62453,37.5,127793,16.9,42559,82.5,3.2
5133,12137,8513,8397,35.4,16910,20.8,38697,69.6,4.2
5135,13540,8638,8519,47.3,17157,21.3,32379,83.2,3.7
5137,10065,6359,6180,49.9,12539,21.8,31955,76.5,3.7
5139,30240,20439,19448,40.1,39887,19.3,41546,83.7,5.1
5141,13292,8358,8270,48.3,16628,16.7,38166,84.3,5.4
5143,171814,114123,113926,31.8,228049,15.8,46367,84.2,3.4
5145,60510,40702,38561,36.7,79263,15.7,44329,84,3.5
5147,5250,3491,3150,45.4,6641,26.3,30400,75.5,6.4
5149,16300,10778,10774,40.4,21552,18,38658,77.9,3.8
6001,1302216,838998,808706,37.3,1647704,10.7,89472,87.3,4.7
6003,876,507,564,50.6,1071,18.6,57481,91.1,5.7
6005,31573,17484,19899,50.7,37383,11.3,59789,88.3,5.3
6007,181375,114627,112237,37.2,226864,19.5,45097,88.3,5.9
6009,37414,22594,22577,51.8,45171,13.1,57990,90.4,4.6
6011,15645,10518,11070,35,21588,11.1,54861,68.1,5.4
6013,873571,580666,554461,39.4,1135127,8.7,90920,89.1,4.9
6015,21730,12566,14974,39.9,27540,23.7,39458,82.2,4.7
6017,147926,92976,92649,45.9,185625,8.7,75100,92.6,5.7
6019,699425,491112,488803,32.1,979915,25.5,48323,73.8,7.2
6021,20640,13872,14213,36.3,28085,16.7,46141,72.5,5.5
6023,110071,68467,68179,37.8,136646,20,43164,90.3,5.6
6025,129051,88695,92188,32.4,180883,23.6,43327,67,9
6027,14424,9025,9119,46.3,18144,12.3,53350,88.5,3.7
6029,626734,430934,453854,31.5,884788,22.4,49812,73.6,7
6031,108850,67326,82459,31.6,149785,17.4,51320,72.9,6.1
6033,50827,32132,31984,46.1,64116,20.7,40818,83.7,6.8
6035,25513,11636,19234,37.8,30870,17.6,49793,81.4,3.5
6037,7884802,5143946,4993969,36.3,10137915,16.3,61308,77.7,5.7
6039,112155,79988,74709,34.2,154697,20.4,49467,71.7,4.2
6041,207317,133485,127166,46.2,260651,7.8,103488,93.1,3.3
6043,14549,8527,8883,51.6,17410,17.9,51233,89.5,5.2
6045,68640,44087,43541,43,87628,19,45247,86.5,6.4
6047,188467,133272,135400,31,268672,20.3,47442,68.6,9.3
6049,7069,4346,4449,47.6,8795,18.4,42890,86.4,3.5
6051,11304,6496,7485,40.2,13981,11.5,56574,84,5.8
6053,320567,213512,221720,34.1,435232,12.9,62999,70.9,4.1
6055,111914,71669,70497,41.1,142166,7.9,73112,83.9,4.3
6057,81761,50349,48758,50.2,99107,10.9,60501,93.3,4.8
6059,2459892,1606987,1565545,37.8,3172532,11.1,81642,84.5,4.4
6061,295131,195245,185286,42.2,380531,7.2,85326,94.2,4.3
6063,15438,9302,9325,52.1,18627,12.6,53646,91.9,6.1
6065,1773806,1199885,1187856,35.4,2387741,15.3,59951,80.5,6.8
6067,1151401,774637,739823,36.2,1514460,16.3,59728,86.8,6.4
6069,43839,29511,29903,35.6,59414,10.5,73298,78.3,7.3
6071,1566790,1075937,1064159,33.2,2140096,17.6,56194,78.8,6.5
6073,2589424,1649463,1668286,35.7,3317749,12.4,70693,86.4,4.9
6075,752744,427215,443672,38.2,870887,10.2,101873,87.4,4.3
6077,532346,367677,366032,34.1,733709,14.6,59038,78,7.2
6079,232184,139556,143331,39.5,282887,11,69517,90.1,3.2
6081,603275,387799,376998,39.7,764797,6.6,107075,88.6,3.8
6083,346259,222869,223301,33.8,446170,13.9,66360,80.1,4.6
6085,1486226,950854,968548,37,1919402,9.3,110843,87.1,4.4
6087,220649,138642,136031,37.6,274673,13.4,75929,86.3,4.7
6089,141017,91585,88046,42.4,179631,17.2,46663,90,4.6
6091,2498,1446,1501,54.7,2947,14.4,48099,89,2
6093,34814,21886,21717,47.5,43603,18.8,40875,88.6,6
6095,340930,221585,218622,37.8,440207,11.4,73200,87.5,6.2
6097,402230,256992,246078,41.8,503070,9.4,73496,87.2,4.5
6099,394443,273906,267654,34.1,541560,14.5,54060,77.6,8.4
6101,71397,48484,48167,36,96651,17.1,51283,79.2,6.6
6103,48055,31827,31449,40.4,63276,20.9,40585,82.9,6.7
6105,10597,6222,6560,51.9,12782,21.3,38727,90.7,4.7
6107,316626,230373,230064,30.9,460437,24.7,45768,68.2,6.2
6109,44844,25832,27972,48.5,53804,15.4,50431,89.8,5.6
6111,649378,429152,420586,37.8,849738,9.8,79470,83.4,4.9
6113,169831,110777,105025,31.2,215802,19,63645,85.6,4.8
6115,54684,37198,38077,32.9,75275,16.6,46054,82.2,6.9
8001,362131,247303,250884,33.6,498187,11.7,65442,82.2,4.3
8003,12691,8282,8372,30.4,16654,24.8,37057,83.8,4.8
8005,483960,322347,314721,36.5,637068,9,70866,92.3,4.3
8007,10533,6405,6449,50.5,12854,12,51998,91.4,4
8009,2824,1778,1790,47.7,3568,20.2,34070,86.3,2.1
8011,4987,2004,3857,41.3,5861,34.1,33951,84.2,2.3
8013,258999,160272,161954,36.2,322226,10.8,74772,94.5,3.9
8014,50704,33549,32980,37.7,66529,5.3,86870,96.1,3.2
8015,16110,8928,10130,48.1,19058,11.4,49877,91.7,2.1
8017,1360,915,933,41.4,1848,14,50558,90.6,6.2
8019,7963,4478,4958,48.4,9436,8.1,68699,96.9,3
8021,5948,4070,4059,39.1,8129,22.7,34390,84,5.3
8023,2986,1751,1970,50.4,3721,30.4,27211,77,5.1
8025,4960,1583,4111,39.1,5694,48,35873,82.8,11.6
8027,3950,2255,2347,57,4602,13.6,52021,91.7,4.4
8029,24262,15226,15216,47.7,30442,17.8,41798,88,4.6
8031,552422,345884,347176,34.4,693060,14,61038,86.4,3.8
8033,1625,982,1074,47.6,2056,13.2,46791,90.9,1.9
8035,239132,165075,163557,38.4,328632,3.4,112399,97.9,2.6
8037,41728,25325,28664,37,53989,7.9,79556,88.8,2.4
8039,19860,12544,12687,46.2,25231,6,86693,96.4,3.8
8041,519254,340984,347300,34.1,688284,11.5,63610,93.9,4.6
8043,39731,20078,27368,44.8,47446,17.5,46372,88.7,3.1
8045,43886,28882,30005,36.6,58887,9.1,69161,86.9,4.5
8047,4966,2802,3129,47.7,5931,7.5,65472,98,2.7
8049,12326,7043,7965,44,15008,8.2,63875,95.7,4.3
8051,13583,7536,8872,34.6,16408,13.8,53753,95.3,5.2
8053,629,386,402,51.5,788,10,51717,94.9,3
8055,5625,3263,3414,55.6,6677,21.9,34626,91.3,6.3
8057,1133,648,709,47.6,1357,14.1,46671,87.8,1.2
8059,455902,287457,284380,40.4,571837,7,74342,94.2,3.6
8061,1081,702,671,48.4,1373,13.9,43951,92.9,2.6
8063,6354,3569,4626,38.8,8195,14.3,48272,83.5,3
8065,5947,3523,4095,36.7,7618,14.6,49064,92.8,4.4
8067,44895,27538,28085,40.1,55623,10.9,58499,94.8,3.4
8069,271968,170342,169651,35.7,339993,11.2,66561,95.7,4.1
8071,11448,6776,7327,46,14103,21.6,38224,85.8,4.4
8073,4532,2347,3296,39.3,5643,18.1,42969,85.2,1.3
8075,17837,9735,12184,38.3,21919,16.4,49407,89.3,4.3
8077,116961,75708,74375,39,150083,15,49825,89.8,5.5
8079,626,355,377,54.5,732,9.3,52641,96.6,1
8081,9746,6329,6780,37.5,13109,12.9,54151,91.1,3
8083,20773,13659,13340,43.4,26999,15.1,40679,90.2,3.7
8085,32332,21014,20457,44.8,41471,16.4,43285,88.8,4.9
8087,20810,14131,14143,36.3,28274,11.7,49129,81,3.6
8089,13950,9240,9055,40.4,18295,23.6,36773,85.8,5.6
8091,4084,2420,2437,53.5,4857,8.8,66813,97.8,4
8093,14358,8076,9090,50.5,17166,9.2,68535,96.3,2.8
8095,3263,2210,2078,42.7,4288,11.5,49046,89.1,1.7
8097,15047,8459,9293,44.6,17752,6.9,74576,95.4,4.2
8099,8876,5942,5980,37.6,11922,20.9,40164,82.6,6.8
8101,127116,83756,81367,39.2,165123,19.9,44644,88.2,5.5
8103,4990,3196,3349,37.1,6545,9.5,58980,91.8,2.8
8105,8800,5813,5666,41.1,11479,17.5,41128,83.4,5.5
8107,20075,11838,12810,40.7,24648,7.2,71322,96.5,3
8109,4962,3162,3227,48.3,6389,27.6,33973,80.8,4.1
8111,612,297,397,50.2,694,15.5,44652,95.4,7.9
8113,6498,3724,4293,41.8,8017,10.1,67251,93.2,3.2
8115,1925,1198,1209,46.6,2407,14.8,42518,91.2,4.8
8117,25502,14007,16367,38.6,30374,7.9,70265,94.7,3.3
8119,19766,11832,12211,50,24043,9.5,63966,94.4,4.6
8121,3800,2341,2567,43,4908,14.3,46304,91.3,2.3
8123,216615,146342,148590,34.4,294932,11.5,63609,87,4.1
8125,7454,5111,4992,38.5,10103,12.3,48963,87.1,1.4
9001,726510,484241,459936,40.1,944177,8.6,89954,89.9,5.6
9003,702006,458751,433638,40.1,892389,10.9,69341,89.3,5.5
9005,148318,92366,90205,47.1,182571,7.2,76323,91.7,4.6
9007,133136,83541,79788,45.5,163329,7.9,80190,93.8,3.6
9009,679954,443461,413414,39.9,856875,11.4,66012,89.5,5.6
9011,216194,134594,135207,41.2,269801,9.3,70258,91.6,5
9013,124238,75281,75837,37.5,151118,7.2,81369,93.8,4.2
9015,92802,58602,57590,41.1,116192,11.9,60869,88.1,5.6
10001,134547,90637,84190,37.6,174827,13.6,53994,86.9,4.9
10003,435202,287159,269828,38.1,556987,11.3,67246,90.5,4.5
10005,178042,113599,106652,48.8,220251,11.6,56618,86.2,4
11001,560277,357940,323230,33.9,681170,18.5,74093,90,6
12001,215694,136138,127358,31.4,263496,22.3,45294,92.5,4.1
12003,21044,13264,14673,36.9,27937,17.2,51904,82.1,3.5
12005,144393,92380,91594,39.7,183974,14.9,48843,88.7,4.5
12007,21559,12315,14611,41,26926,18.6,43058,76.8,4.9
12009,471960,296638,282492,47.5,579130,14.7,51214,91.2,5.1
12011,1502461,980156,929476,40.3,1909632,13.5,54055,88.3,5.8
12013,11445,6592,7831,41,14423,21.9,36708,76.9,4.4
12015,156028,91259,87206,58.8,178465,12.6,44935,89.4,4.3
12017,122491,74279,69342,56.6,143621,16.6,40009,86.7,4.8
12019,158907,105824,102487,39.6,208311,9.6,57476,90.8,5.5
12021,300874,185994,179142,50.5,365136,11.4,62397,85.7,3.4
12023,54045,33367,35932,40.2,69299,17.8,41667,86.2,6.1
12027,28683,15486,20314,40.9,35800,28.6,34146,70.5,3.9
12029,13234,7309,8991,45.9,16300,25.4,34146,77.8,2.1
12031,716496,477562,448693,36.2,926255,14.5,51948,88.9,5.5
12033,249405,158568,156619,37.1,315187,15.2,45004,89.9,4.7
12035,89365,56195,52115,51.3,108310,11.2,50863,91.1,3.6
12037,9973,5109,6792,44.4,11901,23.1,37479,79.6,4.4
12039,35811,24132,21874,40.8,46006,20.6,40865,78.8,4.7
12041,13606,8487,8725,43.5,17212,17.3,41721,82.7,4.8
12043,11730,6176,7794,46.6,13970,21.5,39607,74.4,4.9
12045,13512,6468,9522,44.2,15990,23.5,38381,82.5,4.1
12047,11600,6028,8333,39.4,14361,28.9,34517,75,5.3
12049,20137,12812,14548,35,27360,23.8,37612,68.9,5.8
12051,28640,18770,20520,34.4,39290,25.1,39911,62.9,6
12053,148826,94976,87859,49.1,182835,15.4,46225,87,5.2
12055,83333,51753,49164,53.3,100917,19.1,36864,83.3,5.3
12057,1059602,706085,670153,36.9,1376238,15,54509,87.8,5.1
12059,15541,9097,10390,42.5,19487,24.2,41110,78.3,6
12061,126040,78860,72703,52.6,151563,12.3,49813,87.6,5.1
12063,39186,21646,26583,41.8,48229,22.6,37358,78.4,5.5
12065,11433,6682,7224,46.9,13906,18.9,43453,79.8,3.7
12067,6858,3503,5114,38.2,8617,23.3,40653,74.8,6.2
12069,269625,173181,162215,46.9,335396,11.8,50125,87.8,4.3
12071,590988,368837,353499,48.1,722336,12.8,52989,87,4.5
12073,234128,151084,136738,30.8,287822,19,51041,92.6,6.3
12075,32031,20392,19569,47.2,39961,21.4,33092,81.9,4.9
12077,6672,3141,5061,38.5,8202,23.6,38900,79.1,4
12079,14678,8625,9599,42.8,18224,31.9,33721,82.7,5.6
12081,304472,194301,181587,47.8,375888,12.7,51770,88.5,4
12083,283719,181320,167700,48.7,349020,17.4,39629,86.4,4.7
12085,132397,80415,78286,52.1,158701,11.3,55917,90,4.4
12086,2160919,1396835,1316110,39.9,2712945,18.2,45886,80.6,5.3
12087,67261,37389,41688,47.2,79077,11.5,63892,91,3.1
12089,64496,40979,39643,45.6,80622,10.3,67967,90.9,4.3
12091,156712,99046,102124,37,201170,10.7,58009,91.3,3.8
12093,31309,18587,21727,40.1,40314,20.2,37689,71.9,5.4
12095,1018049,668509,645858,34.9,1314367,16.3,51312,87.7,5.4
12097,253015,170585,165430,36.1,336015,14.8,50716,85.7,5.1
12099,1163846,746040,697770,44.7,1443810,12.6,57607,87.9,4.9
12101,408406,262863,249505,44.9,512368,13.3,46326,88.3,4.3
12103,800551,500130,460600,47.9,960730,13.3,49974,90.4,4.3
12105,516607,339820,326329,40.4,666149,16.4,46289,84,5.2
12107,56655,36614,35663,45,72277,21.5,37526,78.4,5.5
12109,183622,120471,114616,43.7,235087,7.7,78544,94.7,3.6
12111,244642,156800,149707,45.2,306507,17,45509,85.8,5.4
12113,132552,83147,87350,39.6,170497,10.6,62668,90.2,4
12115,352637,215622,196947,55.6,412569,10.8,55088,92.6,3.5
12117,359190,235856,219623,39.4,455479,11.4,61253,93.4,5.2
12119,115231,61959,62037,67.1,123996,10.5,56568,90.5,1.9
12121,34618,20901,22893,42.5,43794,20.4,40572,79.1,5.2
12123,17842,9825,12350,41.7,22175,22.5,40180,78.7,3.1
12125,12253,5201,9941,39.7,15142,24.7,43795,74.4,3.7
12127,435362,271696,257668,46.9,529364,14.2,45356,89.3,4
12129,25104,14388,17505,40.2,31893,13.1,56158,87.7,4
12131,52556,32609,33280,44,65889,13.1,54686,84.9,4.1
12133,19670,11210,13359,41.5,24569,22.8,34787,79.8,4.7
13001,13810,9233,9195,38.9,18428,19.7,37954,76.4,4.5
13003,5939,4126,4147,35.5,8273,26.4,33318,67.9,3.5
13005,8442,5762,5610,37.4,11372,22.9,36873,80.1,2.8
13007,2521,1618,1532,45.1,3150,27.8,35452,78.8,1.6
13009,36440,22298,22846,35,45144,26,40683,81.7,4
13011,14188,9017,9380,41.3,18397,15.5,43370,75.4,4.4
13013,56602,39254,37872,35.4,77126,12.9,54893,82,5.5
13015,78196,52636,51171,37.9,103807,15.1,52497,81.6,4.7
13017,12773,8985,8258,38,17243,26.4,32644,81.2,3.5
13019,14339,9619,9374,39.8,18993,22.3,39174,80.3,5.3
13021,114601,80899,71861,36.1,152760,26.3,38115,84.3,6.4
13023,10300,6759,6211,37.7,12970,21.7,41447,85.2,2.9
13025,13949,9281,9074,40,18355,20.8,37675,80.2,4.7
13027,12218,7980,7707,42.5,15687,24.9,33676,79,9.9
13029,25643,18360,17870,34.5,36230,9.6,77244,90.4,6
13031,59889,37949,36773,28.4,74722,24,42083,86.6,5.7
13033,16742,11831,10857,37.7,22688,26.7,37410,77.3,3.9
13035,18868,11155,12662,39.2,23817,17,46141,77.2,4.2
13037,5171,2502,3822,39.5,6324,33,33478,76,5.2
13039,40223,25481,27527,32.3,53008,15,53130,91,5.3
13043,8190,5564,5346,39.5,10910,25,32970,75.3,3.9
13045,88117,59374,56887,34.4,116261,14.9,50598,81.1,6.6
13047,50911,34175,32223,40.5,66398,12.9,53740,85.6,4.6
13049,10113,5143,7354,38.8,12497,27.2,38948,80.9,6
13051,225589,149771,139311,35,289082,16.6,52746,89.3,5.8
13053,8793,3435,7487,24.4,10922,21.5,44097,90.2,4.8
13055,19288,12158,12666,40.3,24824,20.1,37345,72.5,5
13057,180570,122643,119046,38.6,241689,7.5,78668,89.8,3.7
13059,102871,65273,59434,27.8,124707,27.9,36692,86.2,5.1
13061,2372,1590,1430,46.7,3020,35.2,27648,82.3,8
13063,200429,148191,131271,32.5,279462,20.8,44598,83.6,8.1
13065,5066,3472,3357,37.2,6829,26,34777,76.4,5.6
13067,566253,387181,360969,36.5,748150,10,70950,91.2,4.8
13069,32421,20977,22035,35.6,43012,23,38704,78.7,3.7
13071,33454,23050,22658,36,45708,25,34931,72.5,4.4
13073,109631,75392,72058,36.5,147450,7.2,74908,91.9,4.2
13075,12588,8900,8267,37.3,17167,25.1,35518,76.4,3
13077,105098,72020,68506,38.3,140526,9.9,71114,88.6,4.3
13079,9761,6130,6192,44.6,12322,19.3,44014,80.5,5.1
13081,17138,12006,10715,39.3,22721,30.3,34211,79.7,7.8
13083,13109,8279,7978,41.4,16257,15.6,36213,80.1,3.5
13085,18728,11808,11796,44.1,23604,10.2,61229,86.5,4.5
13087,20202,13830,12992,38.6,26822,29.9,36136,79.5,3.3
13089,564724,389564,350757,35.5,740321,17.5,56053,88.6,6.7
13091,16398,9858,10705,41.1,20563,25.2,35779,81.5,5.4
13093,11231,6288,7475,42.7,13763,28.5,40591,74.5,4.6
13095,67741,48430,41587,35.2,90017,30.5,35750,82.2,9.9
13097,104664,74473,67751,36.5,142224,12.9,59665,88.3,6.1
13099,7744,5491,4848,40.6,10339,31.4,26934,79.8,3.9
13101,2894,1958,2004,34.6,3962,23.2,35892,67,4.3
13103,43100,29428,29284,36.1,58712,10.3,63776,86.2,3.9
13105,14929,9942,9201,42.8,19143,22.3,37131,78.5,4.2
13107,16998,11468,11167,37.4,22635,27.4,32495,77.8,6
13109,7838,5495,5175,37.2,10670,24.4,34689,77.1,4.5
13111,20586,12776,12124,51.6,24900,14.1,41487,83,4.5
13113,85603,57490,54137,43.6,111627,6,83145,94.6,4
13115,73840,49820,46740,38.1,96560,15.8,46634,79.7,5.4
13117,158842,111223,109786,38.5,221009,5.7,101804,92.2,3.3
13119,17453,11370,10950,41.6,22320,21.4,41543,76.6,3.9
13121,791838,528208,495128,35.5,1023336,16,62824,91.3,6
13123,23783,14883,14850,46.6,29733,15.2,46332,80.3,4.2
13125,2313,1520,1486,42,3006,18.5,41412,78.6,4
13127,65279,44515,39987,41.2,84502,19.1,48691,87.6,4.8
13129,42685,28692,28212,37.9,56904,16.1,45705,75.4,4.6
13131,18561,12777,12031,39.4,24808,21,40234,77.1,4.9
13133,13788,8756,8247,49.9,17003,18.2,47194,82.3,3.2
13135,657829,463555,443580,35.2,907135,11.3,67197,87.5,4.7
13137,34231,23246,2.10E+04,39.7,44246,15.6,46828,78.3,3.7
13139,145551,98846,97791,36.6,196637,13.7,55308,77.3,3.6
13141,7231,3894,4746,45.2,8640,33.5,30616,72.9,3.4
13143,22094,14924,14118,40,29042,18.5,43196,78.3,5.8
13145,26315,16844,16808,43.9,33652,8.7,70724,89.8,5
13147,20122,12900,12653,44.3,25553,17.3,41247,80.9,2.8
13149,8865,5777,5710,41.4,11487,19.7,41994,78.9,5.6
13151,163292,116207,105561,36.9,221768,9.6,67150,89.4,5.8
13153,112968,78216,73906,35.4,152122,14.9,61795,89.8,5.5
13155,7389,4565,4857,40.4,9422,23.6,35866,84.7,3.2
13157,48083,32687,31928,37.9,64615,12.7,55426,81.7,4.1
13159,10387,6973,6681,41.3,13654,16.9,48473,77.2,5.1
13161,10822,7567,7310,37.1,14877,23.9,35538,78.4,2.8
13163,12161,8194,7722,40.3,15916,25.2,33680,74.5,6.5
13165,6966,4133,4716,38.8,8849,34.2,30611,77.8,2.9
13167,7740,4132,5373,42.1,9505,29.4,32201,74.3,5
13169,21878,14776,13847,40.6,28623,12.3,54155,87.5,4.8
13171,14673,9586,8883,38.3,18469,18.2,44575,84,6.8
13173,7749,5127,5272,35.4,10399,22.8,35690,78.2,7.2
13175,35831,25030,22486,39.3,47516,25.6,39037,82.9,2.9
13177,21553,14621,14716,36.8,29337,11.2,62972,88.5,4.5
13179,44964,30451,32119,27.8,62570,15.3,44154,89.7,7.3
13181,6283,4014,3814,46.9,7828,19.1,41494,83.4,4.8
13183,13164,9250,9187,32.3,18437,18.6,44542,87.3,8.7
13185,87200,58666,55962,30.3,114628,22.1,41331,84.4,6.4
13187,25745,15825,15620,37.4,31445,16.2,47287,84.2,4
13189,15987,11446,10044,39.1,21490,22.8,39642,79.9,4.7
13191,11485,7096,6831,49,13927,20.6,40788,82.4,5.2
13193,10815,6075,7375,39.5,13450,32.1,31358,72.2,7.9
13195,22207,14615,14209,41.1,28824,14.9,47151,82.8,4.5
13197,6675,4277,4247,44.1,8524,23.4,38734,78.4,7.4
13199,16473,10955,10119,42.8,21074,21.2,34508,77.1,5.8
13201,4562,3086,2840,42.6,5926,23.1,42771,79,4.2
13205,17255,10783,11676,39,22459,29.9,33490,76.6,8.6
13207,21693,13739,13567,43.4,27306,12.2,55626,84.2,5
13209,7146,4395,4665,39.4,9060,22.7,39074,82,3
13211,14040,9398,8772,43.5,18170,13.1,55347,83.4,4.1
13213,29508,19846,19469,38.2,39315,18.1,43203,68.8,5.3
13215,149039,100882,96603,34.1,197485,21.5,40895,86.6,5.7
13217,78472,56263,50736,36.2,106999,17.5,51167,84.4,6.7
13219,26994,18737,18101,39.8,36838,6.8,88570,93.4,2.8
13221,11726,7567,7354,42.9,14921,15.4,45319,79.6,3.2
13223,113913,79833,75992,36.1,155825,8.6,65480,89.6,4.6
13225,20779,13874,12781,36.6,26655,21.4,44330,85.1,6
13227,24531,15606,15226,45.4,30832,11.3,57637,83.2,4
13229,14357,9659,9512,39,19171,17.3,42908,82,4.5
13231,13697,9126,8815,40.9,17941,11.7,56901,87.9,5.9
13233,31046,21184,20592,36.9,41776,18.6,42470,75.7,5
13235,9119,6362,4889,44,11251,25,36611,80.5,2.4
13237,17030,11040,10437,46.1,21477,18.4,44785,84.1,4.6
13239,1916,1203,1132,52,2335,27.1,30483,76.9,8.4
13241,13630,8413,8146,48.6,16559,17.1,41913,85.6,3.2
13243,5677,3865,3312,43.6,7177,30.5,31662,70.7,5
13245,154408,104039,97608,34,201647,25.6,41128,83.6,6.3
13247,66780,47099,42256,38.4,89355,14.7,56689,87.1,6.4
13249,3775,2652,2446,40.1,5098,18.5,43396,80.9,7.7
13251,11006,7139,6905,41.5,14044,27.6,36414,81.1,4.5
13253,6660,4410,4058,45,8468,23.4,34986,82.1,4
13255,49263,33447,31359,38.7,64806,22.4,43065,79.3,5.5
13257,19975,13403,12348,41.1,25751,20.8,37920,81.1,5.8
13259,4915,2141,3564,37,5705,39.2,24945,62.1,4.2
13261,23268,15957,14432,35.8,30389,28.9,35764,77.8,6.9
13263,5031,3261,2910,48.6,6171,23.5,36482,78.6,5
13265,1313,802,791,49.2,1593,28.8,30133,67.2,5.1
13267,19808,10676,14416,37.2,25092,29.8,35567,74.1,2
13269,6560,4284,3948,43.8,8232,24.7,31637,76.1,9.1
13271,13113,6625,9340,40.7,15965,30.8,32327,72.7,1.4
13273,6879,4704,4263,40.4,8967,31.1,34018,73.3,6.3
13275,34368,23790,21458,39.9,45248,21.1,40199,81.9,5.4
13277,30726,21049,19779,35.6,40828,22.1,39982,81.2,2.8
13279,19835,14316,12880,36.7,27196,23.4,36765,79.5,6.1
13281,9873,5965,5426,53.6,11391,15.1,42439,89.4,4
13283,5041,3283,3354,37.4,6637,27.1,32100,77.2,3.4
13285,52480,36300,33705,36.3,70005,20.3,42955,83.6,6.6
13287,6091,4095,3935,39.2,8030,30.4,31969,75.4,4.7
13289,6576,4146,4025,47.3,8171,23.5,38507,69.2,3.1
13291,19245,11798,11130,54.7,22928,15.4,47948,88.7,4
13293,20426,13782,12553,41.9,26335,19.8,34039,79.1,6.7
13295,52748,34399,33497,41.3,67896,18.6,40814,79.7,3.9
13297,67369,46327,43857,38.6,90184,12.8,55267,86.7,4.8
13299,27200,18009,17729,38.2,35738,25.5,34643,81.7,2.8
13301,4302,2855,2587,46,5442,28.2,36789,73.7,6.7
13303,15882,10119,10338,40.1,20457,26.9,35542,78.6,5.5
13305,22692,14592,15512,38.1,30104,22.2,42017,82.1,6.3
13307,2069,1311,1288,46.3,2599,20.8,36329,77.9,2.9
13309,6624,2797,5181,38.5,7978,39.1,29532,76.6,1.9
13311,22953,14704,14180,44.5,28884,14.3,44980,84.6,2.5
13313,76582,52620,51969,35.5,104589,16.1,46796,68.9,6.2
13315,7072,3556,5205,39.8,8761,31,33858,77.4,2.9
13317,7702,5089,4716,45.4,9805,22.9,33735,77.9,4.3
13319,7007,4726,4378,42.8,9104,20.9,47309,82.7,3.6
13321,15974,10776,9972,41.5,20748,21.1,40122,77.4,4.7
15001,155196,99659,98790,42.2,198449,15.4,54684,91.6,4.3
15003,780509,492145,500460,37.4,992605,8.5,80012,91.1,3.1
15005,88,47,41,61.3,88,,,90.5,0
15007,55931,36187,35842,41.6,72029,8.1,63164,91.9,3.3
15009,128817,82904,82482,40.8,165386,9.5,69699,91.8,4.1
16001,335619,221445,222583,36.7,444028,10.8,61571,94.6,3.5
16003,3238,1874,2026,54.6,3900,15,42310,89.7,5.6
16005,61969,42274,42103,33.7,84377,16.8,48453,91.9,4.4
16007,4353,2996,2949,39.5,5945,13.9,45875,93.6,1.9
16009,7047,4504,4588,46.7,9092,18,45285,86.5,5.6
16011,3.10E+04,22537,22664,33.6,45201,13.8,51586,85.9,4.2
16013,16794,10756,11035,42.6,21791,9.8,66210,90,2.6
16015,5905,3430,3694,52.9,7124,13.6,50123,93.8,4.3
16017,34098,21293,21243,48.3,42536,15.4,48097,90.3,2.9
16019,77369,56404,55828,32.8,112232,11.7,59293,91.1,3
16021,8959,5833,5848,44,11681,17,42725,89.4,1.8
16023,1874,1236,1265,43.3,2501,18.2,41706,90.4,3.3
16025,824,521,551,44.5,1072,9.9,49153,87.9,2.8
16027,149512,106757,104941,33.6,211698,15.1,48461,84.1,5.2
16029,4936,3397,3490,37.7,6887,11.3,55152,92.1,1.5
16031,15942,11535,11969,32.7,23504,14.2,48983,81.9,2.8
16033,626,408,452,35.9,860,16.4,42050,69.5,3.1
16035,7101,3818,4679,50.2,8497,15.8,43626,87.9,2.7
16037,3409,2009,2087,53,4096,15.7,45591,92.6,1.8
16039,19384,12410,13608,32,26018,13.9,45003,86.3,4.1
16041,8975,6564,6842,33.2,13406,9.3,54427,90,2.4
16043,9458,6219,6724,37.8,12943,16.5,46465,87.4,3
16045,13181,8600,8584,44.3,17184,17.9,42027,87.3,4.4
16047,11015,7395,7790,36.9,15185,13.8,46948,76.3,2.7
16049,12951,7687,8469,49.8,16156,16.2,42049,88.4,3.2
16051,18290,13769,14070,31.7,27839,10.4,61156,87.4,3.1
16053,15821,11347,11647,32.6,22994,16,48590,75,3.2
16055,118470,78179,76132,40.2,154311,14.5,52019,92.4,4.3
16057,31893,19100,20096,28.9,39196,17.6,43767,96,4.9
16059,6298,3796,3927,52.8,7723,17.7,39934,91.5,2.9
16061,2963,1927,1926,48.2,3853,16,41092,89.4,3.5
16063,3670,2566,2705,34.9,5271,12.8,47754,78.4,3.3
16065,28385,19369,19679,23.2,39048,24.1,41199,96.2,6.1
16067,14699,10219,10397,35.3,20616,15.8,48903,78,3.1
16069,31699,20402,19967,40.9,40369,14.9,50030,91.6,3.6
16071,3104,2162,2181,39.3,4343,13.1,46596,93.6,3.8
16073,8405,5606,5783,39.1,11389,17.3,35866,75,5
16075,16814,11567,11459,38.6,23026,15.9,46595,87.1,4.8
16077,5229,3795,3859,33.4,7654,15.7,45933,79.2,4
16079,9975,6196,6256,47.5,12452,18.9,39285,85.7,5.7
16081,8012,5245,5715,37.1,10960,9.7,60745,91.2,4.5
16083,60306,42281,41233,34.8,83514,14.5,49415,86.9,2.9
16085,8587,5092,5404,48.9,10496,9.6,58738,95.5,2.8
16087,7808,5088,5084,45.5,10172,15.1,41647,83.8,4.8
17001,51519,33999,32579,41.1,66578,12.8,51130,91.7,4.1
17003,4945,3356,3122,44.3,6478,29,33344,75,5.5
17005,13591,7974,8850,41.1,16824,13.6,53631,87.9,3.3
17007,39791,26789,26714,39.1,53503,9.6,62081,86.1,5.5
17009,5731,2380,4382,37.5,6762,16.7,51826,85.9,2.4
17011,26134,16984,16375,44,33359,11.5,53410,90.7,4.4
17013,3884,2458,2436,47,4894,12.2,50952,91.8,3.2
17015,11714,7279,7260,47.3,14539,12.6,50330,90.7,3.7
17017,9642,6272,6404,39.6,12676,13.7,47511,85.6,5.7
17019,169087,104294,104125,29.8,208419,18.9,51032,94.7,3.4
17021,26480,16361,16948,43.1,33309,12.7,49324,88,2.9
17023,12312,8067,7871,42.6,15938,12,49937,89.8,5.6
17025,10295,6725,6575,42.8,13300,16,43478,88.5,3.7
17027,29731,18189,19540,40.6,37729,9.3,61013,89.4,3.1
17029,42914,26979,25364,35.1,52343,19.3,42066,90.2,4.5
17031,4042155,2676948,2526551,36.5,5203499,15,60025,85.8,6.4
17033,15456,9280,10028,42,19308,14.4,46374,89,3.7
17035,8399,5412,5446,42.5,10858,12.4,49733,88.8,3.7
17037,81947,52657,51871,30.9,104528,15.8,59586,92.6,6.4
17039,12709,8179,8047,43.1,16226,10.6,54926,91.7,4.8
17041,14714,9892,9738,38.8,19630,9.8,55891,84,3.4
17043,715565,473314,456054,39.1,929368,7,84999,92.4,4.2
17045,13935,8991,8575,44.5,17566,13.6,47062,87.8,5.6
17047,5057,3315,3208,43.7,6523,11.1,48884,89,4.5
17049,26340,17256,17130,39.7,34386,10.9,51809,91.1,3.3
17051,17175,10179,11610,40.5,21789,15.2,46290,82.5,4.4
17053,10464,6932,6643,42.7,13575,11.2,51861,88.8,4.6
17055,30475,19813,19343,42.7,39156,21.5,40246,87.7,5.8
17057,28424,17104,18432,42.8,35536,14.7,49503,87.6,4.4
17059,4131,2688,2524,45.1,5212,20.5,39634,86.2,4.9
17061,10291,6469,6624,43.1,13093,15.1,44378,86.1,4.7
17063,37591,25222,25215,37.6,50437,7.9,71969,92.9,5
17065,6271,4111,3950,43.3,8061,14.4,47855,89.8,2.4
17067,14661,9320,9188,46.5,18508,12,51721,92.5,4.1
17069,3302,1926,2098,48.4,4024,21.9,39143,83.2,9.2
17071,5576,3480,3389,49.2,6869,11.7,47792,88.9,4.6
17073,38221,24622,24658,42.6,49280,11.5,55287,88.9,3.2
17075,22160,14458,13876,44.2,28334,13.3,47589,88.7,4.1
17077,48152,29368,29502,31,58870,23.4,34982,92.3,5.2
17079,7365,4726,4810,43.1,9536,10.7,51120,90.1,2.6
17081,29925,18636,19824,40.7,38460,15.8,45746,85.9,5.4
17083,17437,11266,10759,43.1,22025,11.2,57243,91.2,4.8
17085,17547,10871,10899,49.3,21770,9.9,54169,92,3
17087,10536,5577,7325,42.6,12902,14.4,48359,83.4,3.9
17089,391728,267327,264388,37,531715,10.5,73684,83.1,4.8
17091,84015,55949,54059,38.2,110008,14.2,54624,87.3,5.3
17093,88356,63004,61691,35,124695,4.6,91952,93.2,3.9
17095,40972,25204,25734,42.5,50938,17.1,43277,88,3.7
17097,528851,351695,351352,38.1,703047,8.7,83344,89.8,4.7
17099,86709,54742,55900,42.1,110642,13.3,56543,88.4,5.9
17101,13265,7169,9208,39.9,16377,18.6,44774,78.1,2.1
17103,27458,16146,18105,43.3,34251,13.3,55563,88.3,3.7
17105,28764,18098,18428,41.5,36526,14.3,54339,88.3,3.5
17107,23850,14539,14988,39.7,29527,13.7,53052,87.4,3.6
17109,25762,15653,15343,32,30996,20.2,44460,92.8,5.3
17111,232717,154106,152898,39.9,307004,7.3,81570,92.6,4.6
17113,134850,88584,83834,33.1,172418,12.6,64271,95.6,3.2
17115,82740,55378,51172,40.9,106550,17.3,47786,89.6,6.3
17117,36135,23244,22664,43.5,45908,13.3,52483,90,5.8
17119,207214,136052,129707,39.9,265759,13.3,56297,92.6,5.2
17121,29423,19533,18607,41.7,38140,15.8,45698,88.5,5.5
17123,9530,6008,5931,46.1,11939,9.8,54807,91.8,3.6
17125,10677,6820,6687,44.8,13507,15.1,46962,87.3,6
17127,11423,7647,7011,44.1,14658,20.6,42833,85,4
17129,9766,6416,6100,43.2,12516,9.7,62966,91.9,3.7
17131,12358,7885,7845,45.3,15730,10.2,56661,91.9,3.8
17133,26387,17214,16854,42.6,34068,4.8,83139,95.4,3.1
17135,23136,13765,15187,42.8,28952,16,46997,86,2.5
17137,27594,16977,17300,41.8,34277,15.7,48600,90.8,4.3
17139,11133,7575,7252,40.2,14827,10,57447,84.1,2.5
17141,39605,25798,25475,42.3,51273,10.2,58812,88.3,4.2
17143,140640,95186,89820,37.3,185006,15.2,52380,90.3,5.2
17145,17207,9700,11657,40.9,21357,15.6,48423,84.9,3.3
17147,12803,8359,8201,42.8,16560,6.8,65797,95.2,4.3
17149,12416,7886,8064,42.8,15950,16.4,41671,87.9,3.8
17151,3587,1973,2184,49.7,4157,18.2,42917,87.2,3.4
17153,4377,2912,2707,44,5619,21.1,35875,82.7,5.7
17155,4500,2746,2865,46.5,5611,8,65902,91.6,3.8
17157,26365,14494,18127,41.6,32621,13.7,50681,84.5,2.7
17159,12346,8060,7870,42.6,15930,14.4,46497,87.3,3.4
17161,112588,73384,71400,40.2,144784,15.6,50952,88.6,4.9
17163,200311,135876,126883,38.4,262759,15.4,50598,90.5,5
17165,19057,12321,11986,42.7,24307,20.4,40690,86.1,7
17167,152723,102552,94947,40,197499,13.8,55090,92.2,4.9
17169,5604,3267,3656,45.7,6923,12.1,49566,88.8,3.3
17171,3984,2584,2469,44.5,5053,11.5,52386,92.3,6.1
17173,17110,10955,10762,44.9,21717,11.7,51069,92.3,3.3
17175,4569,2908,2868,46.7,5776,11.5,56414,87.7,3.9
17177,35745,23491,22133,45.1,45624,15.4,45863,90.7,5.4
17179,103751,68117,66268,40.8,134385,8.8,60590,92.8,3.2
17181,13650,8654,8558,44.3,17212,17.4,45476,85.6,3.5
17183,59522,39235,38876,40.2,78111,20.2,45247,87.2,5.5
17185,8947,5766,5726,42.5,11492,13.5,50195,89.4,5.4
17187,13572,8823,8555,40.3,17378,13.6,48346,87.2,5.1
17189,11189,7062,7092,43.6,14154,9.3,58587,90.7,3.5
17191,12673,8268,8128,42.5,16396,13.9,45583,87.2,3.1
17193,11160,7296,6996,44.4,14292,16.2,44874,87.7,4.8
17195,43935,28553,27983,43.2,56536,11.9,51567,88.7,4.2
17197,512169,347094,342435,37.6,689529,7.2,81640,90.8,4.7
17199,52797,33765,33795,40.8,67560,15.9,48112,90.2,4.4
17201,218367,146114,139759,39.5,285873,15.6,50296,87.4,6.8
17203,29597,19701,19439,40.1,39140,6.6,73055,94,3.4
18001,24171,17718,17514,33.8,35232,15.2,51517,84.2,3.5
18003,274041,189460,180944,35.9,370404,15,51329,89.2,4.7
18005,61921,40620,40782,37.6,81402,11.7,59765,90.3,3.4
18007,6446,4338,4312,40,8650,11.5,47218,89.7,3
18009,9453,6163,5986,44,12149,12.8,42588,87,4.8
18011,47390,32593,32060,37.9,64653,7,80634,93.2,2.3
18013,12134,7510,7402,48.6,14912,10.9,56323,89.6,3.3
18015,15422,9999,9971,42.7,19970,10.3,55708,88,4.4
18017,28997,18916,19030,40.4,37946,12.5,46287,82.8,4.7
18019,89507,59350,56681,39,116031,10.5,51837,87.9,4
18021,20335,13335,12974,41.3,26309,14.2,50185,89.7,3.9
18023,23984,16359,16098,38.6,32457,13.7,53862,86.1,3.9
18025,8205,5203,5336,43.4,10539,17.2,46210,82.7,3.4
18027,23297,16444,16525,34.7,32969,14.2,49237,74.7,3.5
18029,38016,24756,24575,41.9,49331,8.2,63876,90.6,4.8
18031,20051,13391,13207,39.2,26598,11.5,51999,89.1,3.5
18033,32174,21473,21273,39.2,42746,9,52599,89.7,4.1
18035,93955,59789,55814,35.4,115603,21.6,41404,89.5,5.6
18037,32381,21369,21183,40.6,42552,6.6,62852,88,2
18039,146987,102978,100803,35.4,203781,13.2,54582,80.5,4.2
18041,18144,11790,11541,42.8,23331,17.8,44673,81.2,5.1
18043,59398,39660,37330,40,76990,10.3,58703,89.4,4.3
18045,12831,8263,8223,43.3,16486,13.2,43571,88,4.8
18047,17285,11304,11411,41.8,22715,10.7,57674,87.4,3.9
18049,15290,10120,10019,41.2,20139,12.5,46662,84.9,3.7
18051,25789,16917,16786,40.4,33703,10.8,54690,90.1,2.4
18053,53014,34934,32003,40.3,66937,20.3,40177,86.5,4.7
18055,25126,16085,16126,43.2,32211,16.1,46019,85.6,3.6
18057,228476,161871,154502,36.8,316373,4.8,92406,96,2.6
18059,56419,37416,36301,40.4,73717,7.3,70655,94.2,3.3
18061,30735,19865,19961,41.6,39826,10.2,57573,88.7,4.1
18063,119551,80414,80196,37.7,160610,5.8,78464,93.5,3.5
18065,38463,23313,25208,42.6,48521,16.2,45356,87.8,4.6
18067,63755,42535,40033,41.5,82568,14.8,49204,88.5,4.5
18069,28437,18475,17925,40.3,36400,11.1,50138,90.1,3.3
18071,33197,22061,21952,38.8,44013,13.1,51871,87.1,3.5
18073,25483,16782,16651,39.5,33433,9.4,56034,87,4
18075,15538,10622,10424,39,21046,13.9,46949,84.1,4.7
18077,25601,16783,15635,41,32418,13.4,51534,86.9,4.3
18079,21196,13800,13958,40.6,27758,12.7,50425,84.5,4.2
18081,114108,77053,74929,37.3,151982,7.6,67215,91.5,3.7
18083,29674,18632,19112,37.8,37744,17,43897,88.5,3.3
18085,59801,39862,39230,38,79092,10.4,56010,84.8,3.4
18087,26165,19402,19708,31.6,39110,10,60402,64.3,2.6
18089,368980,250719,235127,38.7,485846,16.6,53600,87.6,5.9
18091,86038,53357,56658,40.4,110015,15.7,52763,87.5,5.1
18093,35494,22937,22581,43,45518,13.7,47997,88.4,3.4
18095,101019,64844,64452,40.5,129296,17.5,45853,87.5,4.5
18097,706437,487834,453395,34.2,941229,18.9,45300,85.7,6.1
18099,34857,23377,23179,39.6,46556,12,53767,84.5,4.8
18101,7864,5024,5147,42.6,10171,12.4,51008,84.4,3.3
18103,28065,16679,19204,40.4,35883,15.7,47650,85.1,5
18105,122480,72986,72510,29,145496,23.8,44442,92.2,4.1
18107,29370,18876,19198,40.5,38074,11.3,51527,88.5,3.5
18109,53658,35200,34498,41.9,69698,10.5,60482,88.4,4.1
18111,10926,6830,7094,43.1,13924,12.2,51183,85.8,4.3
18113,35693,23779,23859,39,47638,11.4,52318,84.7,4.5
18115,4807,2953,2979,47.2,5932,10.1,54422,88.6,3.7
18117,14898,9725,9610,42.4,19335,16.3,41077,83.3,3.2
18119,16318,10372,10468,44.2,20840,13.8,46069,84.3,4
18121,13170,8835,7965,42,16800,16.3,47599,85.5,3.7
18123,15020,8909,10057,41.6,18966,14.9,48905,87,2.3
18125,9712,6174,6257,44.1,12431,11.4,49578,86.3,2.4
18127,130063,84912,82879,39.7,167791,7.8,67302,91.7,3.9
18129,19787,12799,12677,42.5,25476,8.7,61619,94.3,2.9
18131,9846,6200,6460,43.1,12660,11.5,47243,87.1,4.3
18133,30135,17749,19687,38.8,37436,12.6,50896,88.4,3.5
18135,19237,12759,12323,42.5,25082,15.4,46750,86.4,3.8
18137,22019,14672,14174,41.5,28846,12.2,55129,86.8,4.1
18139,12845,8491,8158,42.4,16649,13.9,50412,84.6,3.4
18141,204822,138220,130921,36.5,269141,16.2,48960,87.7,4.8
18143,18409,11995,11735,41.3,23730,15.8,47738,84.6,4
18145,34122,22357,21967,41.3,44324,12.3,53019,87.7,5.1
18147,15982,10231,10417,43.6,20648,9.1,58217,89.4,3.7
18149,17760,11497,11512,42,23009,16.1,46602,82.9,5.4
18151,27113,16730,17386,42.9,34116,10.7,54071,88.5,3.7
18153,16604,9502,11300,40.6,20802,14.2,46706,86.4,2.9
18155,7905,5144,5383,40.4,10527,17.2,45337,82.7,4
18157,148766,91917,96142,28,188059,17.6,51385,90.7,3.9
18159,11998,7593,7589,44.9,15182,8.5,60756,88.3,3.2
18161,5673,3632,3580,43.7,7212,12.8,46862,88.2,3.3
18163,142155,93757,87964,37.8,181721,17.4,46750,89.8,3.6
18165,12189,7857,7788,43.3,15645,13.3,51425,89,3.4
18167,85727,53031,54900,36.1,107931,17.8,43560,87.7,4.8
18169,25100,16322,15440,42.8,31762,11.5,51561,87.9,3.6
18171,6368,4105,4061,44.8,8166,9.1,55466,91,3.2
18173,47323,31666,30832,40.8,62498,7.5,65809,92.8,3
18175,21336,13920,13750,41.4,27670,14.3,48939,85.5,5.1
18177,51847,34361,32207,41.4,66568,17,42983,84.7,4.2
18179,21178,14102,13847,40.6,27949,9.7,56054,91.2,2.4
18181,18453,12083,11916,43.2,23999,10.9,47439,89.6,3.4
18183,25690,16754,16695,41.4,33449,9,54873,90.1,3.1
19001,5579,3591,3501,46.3,7092,10.7,53416,93.4,1.8
19003,2884,1848,1845,45.8,3693,12.3,46939,92.5,2
19005,10743,6800,7084,45.4,13884,13.2,49439,88.1,3.1
19007,9695,6308,6154,44.8,12462,18.7,39124,89.9,3.9
19009,4542,2899,2779,49,5678,11.1,49560,89.6,1.8
19011,19638,12917,12782,42.2,25699,7.8,63069,92.8,2.6
19013,104227,67741,65163,35,132904,16.1,50887,90.8,4.2
19015,20705,13136,13396,41.5,26532,9.2,60421,94.4,2.9
19017,19322,12573,12225,39.5,24798,6.7,65733,95.3,2.2
19019,15438,10561,10431,38.8,20992,10.1,57228,92.3,2.5
19021,15175,10066,10266,35.2,20332,12.1,52344,78.2,3.2
19023,11395,7417,7374,43.9,14791,9.8,54970,91.9,2.1
19025,7753,4749,5097,44.5,9846,12.4,50767,92.2,1.6
19027,15496,10432,10005,41.9,20437,8.8,56292,92.9,1.8
19029,10151,6648,6509,44.1,13157,12.8,47897,90.3,2.1
19031,14311,9289,9165,43.3,18454,6.6,63672,93.4,2.3
19033,34083,21981,21089,44,43070,11.7,53109,93.3,2.7
19035,9107,5755,5753,47.5,11508,10.9,53534,90.6,2.1
19037,9190,5965,6058,43.5,12023,10.9,49197,90.3,2.1
19039,6956,4647,4662,40.3,9309,11.6,47753,90.7,3.1
19041,12621,8285,8048,42,16333,9.1,53549,93.2,2.2
19043,13748,8746,8844,46.4,17590,9.9,53809,91,2.6
19045,36455,24088,23221,42.4,47309,13.5,49850,91.6,2.9
19047,12647,8221,8719,38.3,16940,14.1,51473,78.5,3.8
19049,60713,42906,41610,35.2,84516,4.9,82123,95.5,1.6
19051,6304,4448,4412,37.2,8860,12.9,49636,86.7,2.5
19053,6371,4034,4107,36.1,8141,20,36808,86.9,3.4
19055,13209,8636,8691,43.2,17327,9.5,56747,90.7,2.4
19057,30738,20299,19440,42.1,39739,16.1,48991,92.2,3.6
19059,13911,8643,8600,48.1,17243,7.8,58019,95.6,2.2
19061,74708,49076,47927,38.5,97003,10.5,59403,92.3,2.7
19063,7576,4802,4856,42.8,9658,10.9,48035,89.6,3.4
19065,15850,9977,10077,43.7,20054,12.8,52192,89.8,2.7
19067,12227,8041,7832,43.5,15873,12.9,49771,89,2.3
19069,7820,5033,5137,43.8,10170,11.6,52860,88.6,3.4
19071,5414,3485,3465,45.5,6950,11.6,53861,92.1,2.4
19073,6953,4571,4440,44.9,9011,11.2,48769,92.8,3.8
19075,9428,6244,6069,42.7,12313,6.3,64146,95.4,2.5
19077,8218,5305,5320,45.5,10625,9.9,55531,92.1,2.1
19079,11582,7600,7476,42.8,15076,9.3,58920,92.2,1.9
19081,8408,5387,5448,44.5,10835,8.8,57222,92.7,1.1
19083,13655,8643,8583,44.2,17226,11,50616,91.7,2.1
19085,10929,7113,7036,44,14149,10.9,55325,91,1.8
19087,15438,9627,10146,41.2,19773,12.4,50684,92,2.9
19089,7021,4664,4668,41.9,9332,9.8,49916,88.9,2.4
19091,7298,4781,4706,43.4,9487,10,54315,93.1,2.4
19093,5342,3488,3497,43.5,6985,10.2,53300,93.3,2.4
19095,12552,8225,8086,43,16311,7.2,57771,92.1,1.2
19097,15166,9759,9713,45,19472,13,49769,91.2,3
19099,28534,17898,18810,42.1,36708,10.1,53829,92.4,3.1
19101,15204,8167,9923,41.4,18090,14,46617,94.9,3.9
19103,117033,73853,72694,30.1,146547,17,58904,94.7,2.3
19105,15975,9805,10634,43.1,20439,10.5,55210,92.1,2.7
19107,7777,4979,5140,43.6,10119,12,49898,91.3,3.5
19109,11784,7527,7587,45.8,15114,11.4,55129,94.3,1.2
19111,27239,17223,17392,43.4,34615,14,49654,91.8,4.9
19113,169048,112156,109505,37.5,221661,10,64625,94.6,3
19115,8586,5468,5674,41,11142,11.4,52271,82.7,2.8
19117,6678,4285,4362,45,8647,14.9,55871,91.8,3.2
19119,8421,5781,5973,37.9,11754,7.3,62496,90.6,1.3
19121,11846,7895,7953,41.4,15848,7.8,64776,94.4,3.3
19123,16845,10959,11222,39.3,22181,12.3,51839,91.1,4.2
19125,25194,16634,16555,38.8,33189,8.5,61098,92.9,2.7
19127,30176,19973,20339,39,40312,12.2,53645,84.7,3.8
19129,11397,7438,7534,42.9,14972,8.8,75550,93.3,2.5
19131,8185,5455,5308,43.8,10763,10.1,55129,91.2,2.3
19133,7014,4507,4391,47.2,8898,12.8,47371,90.5,2.4
19135,6024,3952,3918,42.6,7870,12.5,49402,88.1,3.7
19137,7927,5231,4994,45.1,10225,12.9,47197,89.1,5.2
19139,32025,21532,21408,38.2,42940,10.8,57583,86.9,3
19141,10723,6999,7021,42.5,14020,10.1,50607,92.1,1.8
19143,4636,2973,3091,44.5,6064,10.5,55375,87.6,1.9
19145,12316,7312,8079,43.8,15391,14.7,49507,88.4,2.5
19147,6980,4546,4501,42.6,9047,10.3,50642,93.6,1.3
19149,18946,12710,12490,40.9,25200,8.4,66070,92.1,2.4
19151,5320,3466,3420,46.6,6886,11.8,51260,93.2,3
19153,354593,240729,233316,35.3,474045,10.9,64169,91.7,3.8
19155,71433,47472,46110,39.2,93582,10.3,55442,90,3.3
19157,14801,9505,9028,40.7,18533,11,52408,93.4,2.8
19159,3872,2571,2497,45.2,5068,14.3,47638,90.8,3
19161,7660,5030,4846,46.4,9876,11.6,54660,91.7,2.5
19163,131122,87800,84674,38,172474,13.4,56208,93,3.2
19165,9161,5974,5826,46.7,11800,9,59121,91.3,2.2
19167,25441,17381,17517,33.5,34898,7.3,66605,89.9,1.3
19169,80846,46375,50715,25.7,97090,19.2,55561,96.3,3.5
19171,13147,8716,8603,42.7,17319,12.1,50468,90.6,3.7
19173,4754,3093,3123,42.6,6216,12.3,50695,90.9,2.1
19175,9627,6356,6064,41.4,12420,13.2,47422,91.9,2.7
19177,5584,3589,3682,44.7,7271,14.5,44875,88.3,2.2
19179,27130,17660,17322,39.7,34982,16.6,41312,86.3,4.3
19181,37311,25194,24497,38.3,49691,6.8,74031,95.6,3.7
19183,16692,11245,11036,40.7,22281,9.9,57315,90.8,2.9
19185,4829,3295,3157,42.3,6452,17.9,41118,89.2,1.7
19187,28869,17741,19028,39.1,36769,14.3,48013,90.6,4
19189,8297,5418,5213,43,10631,10.5,52953,91,4.3
19191,16792,10364,10197,40.9,20561,9.4,62115,94.4,1.8
19193,75734,51756,51023,35.5,102779,13.3,51877,85.7,3.5
19195,6001,3792,3780,44.9,7572,8.9,54628,92.3,4.1
19197,9741,6344,6435,44.1,12779,12.6,47815,90,3.8
20001,9797,6482,6232,41.3,12714,15.5,41950,90.4,3.2
20003,5895,3916,3911,42.7,7827,12.9,49215,90.9,2.3
20005,12575,8418,7962,36.5,16380,15.8,49826,92.6,4.2
20007,3638,2268,2420,44.7,4688,12,47540,92.4,2
20009,20303,13511,13264,39.2,26775,13.9,47194,86.8,3.7
20011,10924,7376,7241,38.6,14617,17.4,44424,90.5,1.5
20013,7267,4947,4737,41.8,9684,13.3,43960,92.9,2.5
20015,49797,33346,33679,37.8,67025,8.9,60836,92.8,3.4
20017,2102,1309,1360,44.8,2669,11.4,44940,90.4,2.3
20019,2674,1647,1727,47.8,3374,17.5,40859,88,3.5
20021,15485,10167,10079,42.2,20246,15.8,41140,87.2,3.9
20023,2102,1333,1328,47.5,2661,11.2,42649,94.5,1
20025,1562,1052,1020,41.9,2072,11.5,51280,90.4,1.2
20027,6217,4101,4042,43.3,8143,10.3,50291,93.8,2
20029,7115,4643,4507,40.6,9150,13.2,42431,92,3.8
20031,6551,4303,4130,44,8433,10.4,57224,92.7,3
20033,1404,955,907,45,1862,11.7,44898,93.4,3.1
20035,27137,17844,17909,38.2,35753,14,45907,89.1,3.6
20037,30504,19631,19533,33.4,39164,22.3,39521,90.1,3.6
20039,2268,1397,1435,51.5,2832,14.8,41095,91.9,1.7
20041,14471,9524,9540,41.4,19064,11.1,50268,89.2,3.5
20043,6087,3833,3831,40.6,7664,13.7,47320,90.7,3.2
20045,96957,59898,59542,29.4,119440,15.8,55446,95,3.6
20047,2248,1451,1487,45,2938,11.2,46825,83.2,1
20049,2041,1286,1261,51.9,2547,17.9,40227,90.4,3
20051,22661,14357,14536,32.9,28893,12.4,52265,93.3,2.4
20053,5201,2739,3589,43,6328,10.2,50403,90.7,1.8
20055,25387,18005,18717,30.8,36722,14.3,51812,72.1,3.5
20057,23621,16385,17586,31.7,33971,13.4,47175,71.2,5
20059,19271,12816,12744,39.1,25560,11.9,50155,91.9,4
20061,24718,16681,18905,26.3,35586,11.6,46326,91.3,4.9
20063,1960,1269,1320,43.8,2589,10.4,51445,91.9,1.2
20065,2026,1293,1271,49.8,2564,12.3,42224,93.8,1
20067,5219,3782,3864,32.4,7646,12,58620,70.3,3.5
20069,4268,2997,3037,36.7,6034,8.2,64274,75.8,2.1
20071,968,675,621,41,1296,11.7,47620,88.3,0.7
20073,4877,3061,3090,48.6,6151,14.8,40518,90.2,2.4
20075,1777,1243,1293,34.2,2536,13.5,49932,81.2,1.3
20077,4287,2842,2843,42.4,5685,14.6,42023,89.4,2.7
20079,26266,17753,17160,38.7,34913,10.5,56848,90.7,2.3
20081,2862,2010,1996,35.6,4006,10.1,50514,71,2.6
20083,1447,949,921,47.6,1870,9.9,51244,93.4,0.9
20085,9963,6666,6625,41.4,13291,8.9,57869,94.7,3.3
20087,14530,9272,9625,43.7,18897,9.5,62285,92.3,4.6
20089,2350,1414,1487,53,2901,12.7,40940,94.4,1.2
20091,439345,298003,286448,37.4,584451,5.6,80872,95.8,3
20093,2797,1954,1963,34.6,3917,11.6,59254,77.5,1.5
20095,5829,3738,3729,46,7467,10.7,59721,91.7,3.5
20097,1941,1253,1230,41.4,2483,13,42976,91.7,2.5
20099,15659,10333,10111,41.9,20444,20.8,41103,87.5,3.3
20101,1266,829,807,46,1636,10.1,56677,93.1,2.4
20103,61076,37424,42780,37.6,80204,8.8,67558,91.5,2.9
20105,2333,1533,1540,46.3,3073,12.4,42092,94.5,4.2
20107,7314,4781,4777,44,9558,16.6,44391,89,3.7
20109,2184,1392,1439,40.7,2831,9.9,48453,93.1,2.3
20111,26019,17196,16314,32.8,33510,16.3,43600,88.9,4.5
20113,22190,14686,14118,41,28804,9.7,56488,91,1.6
20115,9499,6085,6027,45.1,12112,11.2,51569,90,2.8
20117,7528,4959,4877,44.3,9836,10.3,48687,93.9,2.1
20119,3122,2092,2124,40.3,4216,10.9,57187,85.5,1.6
20121,24622,16605,16359,41.1,32964,8.2,67651,94.7,2.8
20123,4822,3058,3185,43.5,6243,11.9,49552,95.4,1.7
20125,24978,16588,16158,40.3,32746,18.9,41281,89,4.3
20127,4438,2800,2773,48.2,5573,11.8,48093,87.8,1.7
20129,2125,1417,1431,41.7,2848,12.4,49717,87.6,4.7
20131,7567,5046,5195,40.6,10241,9.3,55324,91.5,1.2
20133,12133,8096,8050,40.1,16146,16.4,42441,91.4,2.2
20135,2321,1503,1459,48.6,2962,11.3,46439,91.5,2.1
20137,4450,2409,3084,43.4,5493,13.7,45845,86.6,1
20139,12126,7901,7942,43.5,15843,10.9,54760,91,4.9
20141,2886,1799,1843,47.6,3642,14.2,41967,91.3,2.3
20143,4541,2874,3046,43.4,5920,10.7,52808,94.1,2.8
20145,5547,2982,3761,44.2,6743,14.7,46961,89.3,0.6
20147,4155,2702,2726,44.4,5428,12.6,49386,93.6,2
20149,16796,11916,11745,34.8,23661,8.2,64704,95.4,2.9
20151,7239,4824,4760,38.8,9584,11.4,51419,90.6,3.2
20153,2014,1259,1290,49.9,2549,12.4,47377,93.7,1.4
20155,48696,31370,31850,40.1,63220,14.7,46208,87.5,3.2
20157,3750,2413,2286,51.5,4699,11.4,43921,94.1,2.3
20159,7527,4857,4974,38.3,9831,12.8,47737,88.7,3.5
20161,60816,34505,38838,25.3,73343,18.2,49901,95.6,3.4
20163,3919,2622,2454,43.6,5076,11.9,45268,91.3,2.6
20165,2463,1512,1546,49.2,3058,12,45281,91.4,3.2
20167,5454,3572,3416,45.2,6988,14.5,43857,90.3,4.2
20169,41977,27807,27335,38.7,55142,12,48748,89.9,3
20171,3710,2504,2528,39.9,5032,7.5,60540,86.3,3.4
20173,378318,258862,253133,35.1,511995,14.9,52612,89,4
20175,15528,11003,11706,29.5,22709,13.6,48648,65.3,6
20177,135317,91805,86341,38.9,178146,10.9,55387,91.1,3.8
20179,1929,1250,1259,46.8,2509,11.5,49860,91.4,0.9
20181,4551,2973,2992,40.3,5965,14.4,48456,91.4,2.4
20183,2931,1830,1802,51.4,3632,14.2,40006,91.6,2.1
20185,3192,2040,2168,43.9,4208,13.3,46104,87.9,2.2
20187,1495,1030,1032,38.4,2062,10.9,58135,81.1,0.7
20189,3928,2832,2752,35.3,5584,10,57432,83.3,2.4
20191,17604,11658,11614,40.9,23272,13.5,52186,91.3,3.7
20193,6065,4046,3846,35.8,7892,10.5,53816,95.3,1.4
20195,2335,1420,1452,49.5,2872,11,46756,94.2,1
20197,5224,3385,3506,43.9,6891,8.1,61502,94.4,3
20199,1127,763,734,43,1497,12.1,47844,89.8,4.4
20201,4293,2739,2807,45.5,5546,10.8,45077,91.2,1.9
20203,1537,1022,1090,39.9,2112,11.7,55336,80.9,1.7
20205,6677,4436,4287,43.6,8723,16.4,43134,87,3.5
20207,2489,1565,1600,46.5,3165,18.4,35417,89.8,3.5
20209,117844,82825,81006,33.7,163831,19.4,43396,78.1,6.2
21001,15332,9731,9549,39.9,19280,26.1,33925,76,3.2
21003,15702,10428,10203,40.5,20631,18.6,41368,76.4,4
21005,16910,11359,10799,40.6,22158,10.6,57448,88.6,4.8
21007,6307,4042,4012,43.8,8054,16.2,45074,86.2,2.9
21009,33549,22683,21310,40.4,43993,21.8,40274,81.7,4.5
21011,9200,6185,6142,40.2,12327,24.9,36468,75.7,5.1
21013,21369,13819,13298,42.2,27117,38.7,26014,68.1,4
21015,93957,64865,63671,36.9,128536,7.6,72942,92.4,3.8
21017,15494,10309,9721,42.2,20030,17.6,46231,84,4.7
21019,37800,24165,23967,42.4,48132,18.2,44569,89.2,4.3
21021,23903,14974,15044,40.5,30018,17.1,44834,86.2,3
21023,6349,4214,4186,40.3,8400,16.7,47182,83.2,5.1
21025,10476,6615,6669,41.7,13284,34.3,26659,71.4,5.1
21027,15364,9935,10026,43.2,19961,17.3,43053,79.7,5.6
21029,61303,39914,39237,40,79151,10.4,63570,86.7,4.4
21031,9954,6429,6416,41.8,12845,17.8,41701,77.6,2.9
21033,9760,6471,6097,43.1,12568,20.4,40327,88.1,4.5
21035,31515,19764,18673,34.8,38437,21.2,39438,88.4,3.9
21037,72514,46904,45307,38,92211,12.5,61490,90.1,3.9
21039,3766,2490,2365,43.2,4855,14.5,45362,81.8,4.5
21041,7948,5332,5347,38.1,10679,20.8,47726,76.4,6.5
21043,20946,13676,13370,40.8,27046,22.6,37406,79.5,5.5
21045,12196,8118,7697,42.2,15815,27.8,29417,73.4,4.7
21047,52528,33923,38428,28.3,72351,20.8,41081,86,5
21049,27808,18280,17539,41.6,35819,15.9,48474,84.5,4.1
21051,16313,9833,10933,39.3,20766,42.1,24901,63.7,4.4
21053,7823,5131,5046,42.4,10177,25.3,29582,71.2,4.3
21055,7055,4558,4630,42.4,9188,18.6,40656,80.2,3.2
21057,5283,3475,3263,45.5,6738,25.3,30771,78.1,3.4
21059,75339,51084,48590,38.8,99674,16.4,51153,88.4,4
21061,9808,6025,6089,44,12114,22.3,38395,77,5
21063,6209,3299,4289,42.7,7588,30.7,33335,75.8,2.3
21065,11197,7238,7069,42.9,14307,27.3,33839,75.7,6.7
21067,251282,162003,156446,34.2,318449,17.9,53288,89.9,4.3
21069,10934,7341,7166,40.8,14507,21.2,38860,76.8,5.6
21071,29040,18994,18116,41.8,37110,30.4,31295,75.8,4.7
21073,39932,26133,24427,40.9,50560,13.7,52395,87.6,4.8
21075,4881,3121,3058,42.5,6179,30,30605,77.3,5.1
21077,6486,4272,4337,38.8,8609,14.5,49945,80.3,3.5
21079,13484,8776,8516,43.2,17292,16.3,46967,80,5.2
21081,18150,12486,12437,36.7,24923,15.6,49312,82.5,3.6
21083,28197,19010,18172,40.5,37182,20.7,41705,81.7,4.8
21085,19981,13033,13151,40.2,26184,22.1,38418,79.1,3.8
21087,8712,5573,5487,44.9,11060,20.4,36246,77,4.1
21089,28070,18425,17468,43.3,35893,17.4,46815,86.8,4.9
21091,6557,4265,4545,40,8810,12.6,56823,88.3,3.7
21093,80851,53782,53534,36.8,107316,13.8,52040,89.6,4.6
21095,21092,14038,13130,41.9,27168,37.1,25240,71.4,4.1
21097,14349,9524,9122,42.3,18646,15.3,49615,82.2,3.9
21099,14164,9391,9236,41.1,18627,21.8,36628,74.6,3.6
21101,35455,23846,22407,40.1,46253,17.1,46936,86.3,3.9
21103,12083,8005,7813,41.6,15818,18.5,51774,82.6,3.9
21105,3706,2433,2194,46.8,4627,20.1,39859,75.2,3.4
21107,35372,23497,22407,41.1,45904,18.3,43590,85.5,3.5
21109,10359,6720,6648,41.4,13368,31.9,30798,76,5.7
21111,593717,395377,369975,38.2,765352,14.9,52008,89.3,4.7
21113,39489,26871,25486,37.5,52357,15.9,55047,84.9,5.2
21115,17811,11703,11275,41.7,22978,25.9,35408,77.7,4.3
21117,125168,83268,81677,37.1,164945,12.6,61798,89.3,4.4
21119,12313,7828,7716,42.4,15544,38.2,29786,71.7,6.3
21121,24242,16270,15417,39.6,31687,39.2,27432,70,5.7
21123,11009,7156,6940,41.9,14096,16.9,44522,84.1,4.4
21125,46312,30835,29415,39.9,60250,23.2,38323,77.8,5.3
21127,12064,7915,7948,40.6,15863,27.1,33757,77.7,3.9
21129,5237,3259,3321,44.9,6580,39,25372,67.9,4.5
21131,8260,5327,5211,42.7,10538,31.8,28595,63.7,6.1
21133,17812,11603,11170,42.7,22773,31.6,29308,75.1,5.7
21135,10499,6750,6692,42.3,13442,26.8,32848,74.8,3
21137,18738,12392,11980,41.4,24372,22.9,35934,77.5,5.6
21139,7388,4699,4570,46.5,9269,14.5,45229,82.5,2.7
21141,20297,13532,13061,40.9,26593,17.5,43985,78.7,4
21143,6884,3603,4466,49.2,8069,16.4,44767,87.7,2.3
21145,50855,33903,31259,42.1,65162,18.7,42936,87.8,3
21147,13693,8013,9498,39.2,17511,39.3,25087,72.2,6.6
21149,7214,4786,4689,42.7,9475,17.3,43656,83.7,4.3
21151,70769,46107,43440,34.3,89547,21.3,45406,85.7,4.8
21153,9803,6345,6339,41.7,12684,31.9,28996,69.4,5
21155,14481,9704,9501,39.4,19205,20.1,41233,80.7,5
21157,24818,15952,15413,44.9,31365,12.1,50165,85.9,3.7
21159,9587,5375,6627,38.8,12002,39.3,29861,72.5,6.1
21161,13163,8918,8272,41.5,17190,19.4,43683,82.8,3.7
21163,21590,14003,14123,39,28126,13.4,51893,86.5,5
21165,5152,3160,3248,44,6408,24.1,33734,77,5.5
21167,16716,10982,10495,43.5,21477,14.5,51048,84.7,5.6
21169,7660,5056,4962,41.9,10018,22.7,33562,76,3.6
21171,8186,5309,5279,42.7,10588,23.2,33425,75.2,4.7
21173,21124,14200,13571,39.6,27771,17.9,44890,81.7,5
21175,10782,5803,7495,40.8,13298,27.2,33716,73.4,3.1
21177,24602,15218,15810,41.8,31028,19.6,42098,79.5,4.3
21179,34474,23053,22506,38.8,45559,11.6,56239,89,4.6
21181,5412,3585,3499,41.5,7084,19.8,38958,79.4,4.3
21183,18465,12178,12200,39.5,24378,20.3,40859,79.2,5.8
21185,48856,30840,34720,39.3,65560,5.9,92454,92.8,2.6
21187,8233,5338,5304,42.5,10642,18.2,46358,83.5,4.4
21189,3506,2313,2178,42.8,4491,45.2,23115,70.2,3.2
21191,11227,7174,7386,41.4,14560,14.4,51680,84.7,3.3
21193,21284,13883,13460,41.3,27343,30.9,31814,74.9,7
21195,48029,30839,29716,42.4,60555,31.4,32734,75,4.7
21197,9348,6210,6098,39.5,12308,26.5,35169,77.2,3.7
21199,49667,32630,31326,42.2,63956,18.9,37782,80.9,4.9
21201,1730,1053,1102,46.7,2155,24.6,41877,74.9,2.8
21203,13170,8595,8255,42.7,16850,24.2,35567,76.7,5.7
21205,19828,12539,11912,30.8,24451,25.4,38684,81,3.3
21207,13719,9038,8684,43.3,17722,25,33490,73.7,5.2
21209,40358,27463,26509,36,53972,10.4,64809,90,3.7
21211,35306,23894,22514,38.9,46408,11.5,61700,85.8,3.2
21213,13694,9238,8845,39.3,18083,15.1,45643,84,3.3
21215,13972,9038,9236,41.4,18274,8.8,71156,89.5,4.5
21217,19753,13072,12325,38.2,25397,21.3,37806,84.1,4.8
21219,9022,6204,6091,38,12295,20.4,41072,76.9,4.3
21221,11201,7248,7016,46.1,14264,14.5,37965,84.2,5.5
21223,6682,4264,4356,41.9,8620,14.8,51827,83.2,9.2
21225,12012,7075,7805,37.5,14880,18.6,47017,84.9,4.7
21227,97208,63861,61671,33,125532,18.5,47253,87.7,4.4
21229,9378,6192,5997,41,12189,15.7,48041,82.2,3.5
21231,16142,10326,10127,43.2,20453,26.9,30923,70.8,5.8
21233,10200,6739,6577,40.6,13316,17.9,43605,78.5,3.7
21235,27151,18242,17854,36.9,36096,29.3,31985,77.4,4.8
21237,5490,3633,3526,42.3,7159,32.2,28443,69.5,3.7
21239,20279,13506,12618,42.5,26124,12.1,58712,88.1,2.9
22001,46159,32207,30438,36.3,62645,23.1,40218,75.5,5.3
22003,19844,11072,14612,37.2,25684,21.4,41584,79.2,4.3
22005,88229,61377,60210,35.2,121587,10.7,74212,88.2,4
22007,17667,11637,11058,40.4,22695,21.2,45847,72.7,4.5
22009,31303,20397,20720,38.3,41117,25.9,34997,73.2,4.3
22011,27795,18074,18853,37.3,36927,14.8,49436,84.5,3.8
22013,10681,7241,6624,41.9,13865,23.5,33887,82.9,5.2
22015,94283,63700,62357,35.1,126057,16.7,50048,88.2,3.5
22017,188606,130798,118053,37.1,248851,26.4,38414,86.1,4.1
22019,150792,102769,97832,36.1,200601,19.9,47052,85.4,4.6
22021,7727,4888,5199,39.6,10087,22.6,35428,75.9,5.8
22023,5354,3455,3427,40.5,6882,12.3,52479,83.5,2.2
22025,7761,4648,5273,38.5,9921,27.5,33154,77,3.6
22027,13131,7014,9118,41.1,16132,34.9,34228,77.6,6.3
22029,15108,9778,10142,37.7,19920,28.5,32685,77.1,4.7
22031,20617,13977,13172,39.7,27149,21.1,43325,81.3,5.5
22033,345986,233202,213835,33.8,447037,19.9,50451,90.2,4.6
22035,5440,3348,3923,35.1,7271,43.5,25810,70.4,4.1
22037,15940,9043,10640,42.9,19683,20,46172,82.4,2.8
22039,25068,16489,17220,35.9,33709,29.4,34440,71.3,5.5
22041,15170,10460,9870,38.4,20330,29.2,31873,74.1,5.1
22043,17573,9822,12543,37.1,22365,21.5,42948,81,3.6
22045,53767,37517,35756,36.3,73273,23.4,41604,77.8,6.9
22047,25933,16174,16746,38.6,32920,22.8,41679,77.4,3.8
22049,12332,7699,8109,40.6,15808,21.2,41192,80,2.6
22051,340962,224447,212076,39.1,436523,16.1,49681,84.7,4.1
22053,23337,16075,15338,37.6,31413,19.3,42134,79,4.9
22055,183996,123374,118024,34.7,241398,18.1,51125,86.4,3.5
22057,75262,49904,48401,37.3,98305,17.1,52220,75.3,4.4
22059,11549,7280,7772,37.7,15052,19.3,45169,75.8,2.4
22061,38195,24419,23326,27.7,47745,30.2,39158,87.5,6.2
22063,103538,71096,69042,35.8,140138,12.6,58318,83.9,3.9
22065,8680,5800,5728,34.7,11528,41.3,27306,74.4,6.8
22067,19798,13497,12574,39.7,26071,28.7,32269,80.3,4.1
22069,29933,20376,18786,33.6,39162,31.9,32094,83.5,6.1
22071,311819,204987,186508,36.1,391495,24.1,38418,85.7,6
22073,117142,81751,75232,35.4,156983,24.5,38525,85,4.5
22075,17264,11707,11757,36.3,23464,15.4,55950,80.4,2.2
22077,17183,11476,10683,42.4,22159,19.7,42545,80,4.9
22079,99137,68489,63935,37.2,132424,19.9,42452,84.7,4.5
22081,6506,4411,4139,40.9,8550,26.3,33044,80.7,4.3
22083,15442,10472,9958,38.3,20430,27.2,33820,79.5,5.7
22085,18173,12043,11934,40.8,23977,18.5,42700,82.5,5
22087,33309,23166,22522,33.7,45688,23.5,39450,81.8,6.6
22089,39854,26951,25972,37.8,52923,13.1,64742,87.2,5.3
22091,8218,5372,5140,40.7,10512,24.7,35519,79,7.1
22093,16515,11142,10415,38.9,21557,19,47876,85.5,5
22095,32745,22421,21210,37.3,43631,18.5,52166,83,5
22097,61167,43411,40472,36.4,83883,26.6,32185,76.1,3
22099,40648,27401,26606,37.4,54007,18.5,46560,79.1,4.3
22101,39354,26324,25769,38.2,52093,22.2,37822,78.3,6.2
22103,192257,130318,123284,40.1,253602,9.8,65861,88.8,4.6
22105,98538,67431,63279,35.1,130710,21.5,44625,81.4,6
22107,3491,2364,2233,44.4,4597,31.6,26657,76.7,7.9
22109,84055,57392,55828,35.9,113220,21.1,49206,77.8,3.1
22111,17452,11316,11171,42.6,22487,20.2,42166,85.2,3.3
22113,44488,30969,29236,37.1,60205,19.6,44048,76,4.9
22115,37517,23763,26806,30.7,50569,14.9,47172,87.5,4
22117,35126,23388,22922,39.5,46310,27.8,34240,76.5,6.6
22119,30682,20359,19351,41,39710,24.1,33251,81,4.2
22121,19488,13022,12773,35.7,25795,16.8,54454,83.8,4.3
22123,8534,5479,5635,40.8,11114,23.8,35638,75.6,5.3
22125,12834,5241,10103,42.8,15344,23.7,56459,79.3,4.7
22127,11263,6676,7700,40.2,14376,24.3,37600,79.7,3.4
23001,83942,54705,52614,41.1,107319,12.7,48494,89.4,3.8
23003,55426,34355,33604,47.7,67959,16.3,39746,87.4,3.5
23005,235923,149984,142057,42.1,292041,10,65475,94.5,3.1
23007,24570,15281,14720,45.8,30001,14.3,43532,92.4,4.2
23009,44807,28015,26404,48.3,54419,11,53941,93.8,4
23011,96778,61722,58847,44,120569,14.1,51013,91.4,4.3
23013,32540,20087,19657,48,39744,11.4,53610,93.1,3.5
23015,28320,17392,16824,50.7,34216,11.3,54026,93.2,2.1
23017,46340,28783,28434,47.2,57217,13.4,44508,91.5,4.2
23019,123968,76634,75172,42,151806,14.8,47076,91.2,4.5
23021,13972,8483,8360,51,16843,18.9,35874,89.7,5.1
23023,28480,18084,17189,46.4,35273,9.3,59271,94.5,3.3
23025,41035,25651,25264,46.2,50915,19.5,42134,88,5.3
23027,31866,19984,19380,46,39364,14.3,48422,91.9,4.4
23029,25476,15974,15476,47.9,31450,18.4,37711,88,4.6
23031,163322,103760,98583,45,202343,8.1,60520,92.4,3.4
24001,59454,34565,37565,41.2,72130,17.2,44708,89.1,5
24003,441025,287038,281308,38.2,568346,7,95297,91.9,3.8
24005,651198,436977,394049,39.3,831026,9,72305,91,4
24009,69680,46138,45113,40.7,91251,5.8,97188,93.3,5.4
24011,25118,16722,16128,40.1,32850,15.3,49616,83.3,4.9
24013,131019,84829,82827,42.7,167656,5.5,89529,92.1,3.1
24015,78918,51606,50997,40.3,102603,10,70504,88.1,4.3
24017,119509,81638,76067,38.1,157705,7.4,93947,92.8,3.4
24019,25394,16928,15330,44.4,32258,17.4,44491,85,6.5
24021,189166,125426,122165,39,247591,6.9,89541,92.6,3.7
24023,23831,14871,14554,45.6,29425,12.8,46710,88.5,3.3
24025,194471,128379,122653,40.6,251032,7.2,83595,92.8,4.1
24027,239344,162023,155210,38.6,317233,5.2,119386,95.3,3.3
24029,16495,10312,9418,47.8,19730,14,54210,87.3,3.2
24031,799386,540374,503489,39,1043863,6.9,99604,91.2,4.1
24033,703901,471315,436734,36.8,908049,9.2,78680,85.8,5.7
24035,38303,24653,24276,44.8,48929,7.3,79966,91.6,3
24037,84944,56398,56189,36.4,112587,9.1,80049,89.9,2.9
24039,21471,12015,13913,36.8,25928,24.3,38546,79.2,3.4
24041,30373,19666,17612,50.1,37278,10.4,62264,89.2,3.6
24043,116930,73868,76424,40.6,150292,13.2,54643,86.9,4.5
24045,79953,53829,48748,35.7,102577,18,50015,88.6,5
24047,42379,26407,25037,50,51444,11.4,53509,89.6,4.6
24510,485457,326004,288660,34.9,614664,21.8,46604,83.5,7
25001,181277,111822,102454,52.9,214276,7.6,67374,95.4,3.8
25003,104946,65589,61314,46.9,126903,10.9,56011,90.6,5.2
25005,442382,287717,270607,41.1,558324,10.7,65154,83.7,5.3
25007,14133,8774,8472,47.4,17246,7.6,66528,92.8,2.7
25009,610567,403544,375474,40.8,779018,10.7,73503,89.3,4.7
25011,57896,36049,34333,46.2,70382,10,56544,92.8,4.1
25013,365349,241977,226490,38.6,468467,16.5,51589,85.4,5.5
25015,137351,86456,75360,36,161816,11.9,64425,94.3,4.6
25017,1268151,812428,777346,38.3,1589774,7.7,94977,92.6,3.7
25019,8694,5443,5565,40.6,11008,6.4,82324,94.7,2.6
25021,548799,362851,334330,41,697181,6.1,92606,93.9,4.3
25023,400997,263819,249746,42.8,513565,8,81483,92.5,4.7
25025,650153,404547,379683,32.7,784230,19.5,61367,84.8,5.4
25027,642982,415112,404477,40,819589,9.6,69064,90,4.5
26001,9041,5129,5223,58.1,10352,16.2,37900,88.6,4.1
26003,7827,4162,5057,50,9219,13.9,43693,89.4,3.3
26005,87298,57855,57693,40.1,115548,9,58311,90.1,2.9
26007,23210,14578,14126,47.3,28704,15.5,42332,90.4,4.4
26009,18899,11644,11500,50.9,23144,11.7,50356,90.7,4.2
26011,12406,7466,7656,49.8,15122,16.5,43339,86.3,5.4
26013,6912,3803,4700,44.7,8503,16.5,44187,83.3,2.4
26015,46370,29679,30023,42.9,59702,8.4,60818,91.7,3.9
26017,83242,53196,51551,43.4,104747,15.2,45731,89.4,4.8
26019,14321,8888,8684,49.6,17572,10.8,50323,91.5,4.3
26021,119773,78458,75552,41.9,154010,16.7,47237,89.1,4.7
26023,33153,21044,22383,40.7,43427,16.8,48321,88.1,3.2
26025,103274,68668,65718,39.9,134386,16.8,46423,90.6,5
26027,40855,25823,25776,45.3,51599,12.9,51530,87.8,5.3
26029,20999,13255,12919,48.2,26174,11.5,52944,92.7,4.5
26031,21047,12711,12690,50.7,25401,18,41667,88.8,6.8
26033,30699,16894,20830,39.9,37724,16,43683,89.5,5.3
26035,24316,15220,15138,47.3,30358,21.7,37646,84.1,6.1
26037,60296,39406,38482,40.7,77888,8.4,66396,93.7,3.3
26039,11199,6800,6944,50.5,13744,21.4,39208,88,5.5
26041,28840,18224,17978,46.9,36202,14.3,43835,92.6,4.3
26043,20473,12793,12742,46.6,25535,12.8,46094,93.6,3.8
26045,85795,55788,53372,41.1,109160,11.2,57807,93.6,4.3
26047,26618,16756,16426,45.5,33182,11.8,51122,94,4.7
26049,314548,211584,197031,40.4,408615,20.3,44174,89.6,6.8
26051,20365,12496,12626,49.9,25122,18,41251,85.1,4.3
26053,12836,6977,8266,48.4,15243,20.4,36429,92.7,4
26055,73241,46609,45475,42.5,92084,10,57367,94.5,3.8
26057,32853,19304,21898,39.6,41202,18.8,42642,89.6,4
26059,35698,22952,22822,42.4,45774,14.5,49049,87.1,4.3
26061,29212,16775,19780,33.1,36555,20.2,38603,92,3.9
26063,25459,15926,15555,48.8,31481,14.2,44845,88.7,3.7
26065,230418,147852,140199,31.9,288051,20.1,49387,92.3,5.7
26067,49584,29683,34549,38.2,64232,14.5,50383,89.3,4.7
26069,21037,12699,12628,52.8,25327,18.2,39721,88.4,5.4
26071,9356,5640,5555,54.4,11195,15.4,38913,91.7,3.7
26073,58899,36626,34656,27.4,71282,23.4,42924,91.5,6.2
26075,123908,77437,81023,41,158460,13.6,50809,89.8,5
26077,204692,133408,128246,34.3,261654,16.6,53370,93.6,4.8
26079,13574,8423,8840,44.4,17263,15.3,48426,86.6,4.8
26081,483389,325699,316474,35.1,642173,12.1,59649,89.5,4.3
26083,1851,1070,1129,56.7,2199,12.3,42799,94.4,3.3
26085,9584,5622,5874,52.8,11496,21.9,33708,82.1,4.7
26087,69413,43574,44766,44,88340,10.8,56079,90.2,5.4
26089,18221,11080,10685,54.3,21765,8.1,62174,94.8,3.7
26091,77313,48611,49893,41.6,98504,12.5,52738,90.5,4.3
26093,147031,94203,94421,43.3,188624,5.8,79388,95.1,3.6
26095,5293,2650,3708,44.7,6358,20.9,41881,88.8,5.6
26097,9073,5293,5527,52.3,10820,13.7,42887,89.1,6.1
26099,681011,445257,422473,41.1,867730,11,60175,89.2,4.8
26101,20144,11710,12663,49.2,24373,14.2,46851,90.3,5.3
26103,54436,32951,33484,39.3,66435,15.1,50681,94.5,4
26105,22906,14460,14416,46.2,28876,15.3,46624,91.5,5.7
26107,35168,21554,21667,36.4,43221,20.7,41759,89.3,5.9
26109,18898,11463,11818,48.7,23281,13,42306,91.5,4.1
26111,65389,42346,41116,41.5,83462,9.5,58526,94.1,4.7
26113,11605,7409,7693,43.5,15102,14.7,41625,87.7,5
26115,116516,75464,73744,42.4,149208,10,61962,90.4,4.2
26117,48714,30488,32486,40.9,62974,15.6,46877,87.6,4.7
26119,7813,4518,4655,55.9,9173,17,37021,87.1,5.6
26121,132714,87135,86273,39.2,173408,18.8,44473,89.2,6.1
26123,37086,23805,24133,43.1,47938,17.2,47221,85.8,4.8
26125,976130,637220,606750,41.1,1243970,8.7,72078,93.5,4.2
26127,19908,12909,13118,43.1,26027,18,42446,85.7,4.5
26129,17044,10519,10385,50.2,20904,17.3,37842,85.2,5.3
26131,5180,2917,2994,58,5911,15.8,35894,91.7,4.8
26133,17808,11405,11705,43.5,23110,19.1,41018,87.5,4.6
26135,6720,4063,4201,52.6,8264,18.6,36181,83.1,4.7
26137,19228,12336,12134,44.5,24470,14,50061,91.5,4.1
26139,213331,143057,139193,35.1,282250,9,65004,91.7,3.6
26141,10707,6404,6358,54.9,12762,14.7,43484,88.5,5.7
26143,20080,11849,11851,55.6,23700,17.7,37817,88.4,6
26145,150649,98862,93464,41,192326,17.8,45739,88.5,5.5
26147,125452,80338,79249,43.7,159587,13.8,52178,89.5,5.5
26149,45732,30522,30331,39.7,60853,14.9,48271,86,4
26151,32389,20792,20617,45.2,41409,15.5,43579,87.9,5.2
26153,6640,4042,3959,52.2,8001,14.8,42883,89.2,5.5
26155,53734,34670,33884,42.5,68554,12,52716,91.5,5.2
26157,42219,26623,26715,44.5,53338,13.6,46950,89.2,4.8
26159,57306,37798,37425,41.3,75223,16.5,48518,86.5,4.5
26161,295567,184108,180601,33.3,364709,14.6,66040,94.7,4.1
26163,1329947,907494,841872,37.8,1749366,22.9,43570,85.1,7.6
26165,25361,16633,16530,41.9,33163,17.8,40485,88.6,4.6
27001,12953,7706,7877,54.7,15583,13.1,46617,91.3,3.5
27003,262559,172830,173127,38.4,345957,6.8,76497,93.5,3.5
27005,25527,16914,16820,42,33734,12.7,55780,92.4,2.4
27007,34455,23167,22939,33.8,46106,18.3,45344,90.2,6.7
27009,30110,19976,20016,36.2,39992,8.5,53675,92.3,3.5
27011,4008,2568,2482,49.4,5050,11.9,46713,89.6,1.4
27013,53428,32880,33561,30.9,66441,15,53829,94.2,3.5
27015,19768,12777,12554,42.5,25331,8.2,56049,91.1,1.8
27017,27653,17054,18684,41.2,35738,10.2,58509,94.2,2.7
27019,72878,50502,49760,37.5,100262,4.3,94057,95.7,2.3
27021,22803,14209,14784,48.6,28993,15.5,49585,91.3,3.6
27023,9352,6135,5998,41.9,12133,8.9,51675,90.1,1.5
27025,42205,26431,28317,40.8,54748,6.7,74908,93.8,3.7
27027,47822,31828,31047,32.7,62875,12,59937,94.4,2.2
27029,6633,4369,4458,42,8827,16.5,43797,86.5,4.2
27031,4466,2656,2630,52.3,5286,10.1,48884,95.6,1.5
27033,8719,5788,5682,43.7,11470,12,47437,89.9,3
27035,49975,32053,31887,44.3,63940,11,51803,93.5,2.6
27037,314503,212216,205270,38,417486,5.6,79111,94.7,3.3
27039,15041,10264,10242,37.9,20506,7.7,68238,94.3,2.5
27041,29474,18737,18719,44.2,37456,8.6,55257,94.8,2.7
27043,10882,7005,6930,45.6,13935,11.7,49176,90.2,2
27045,15908,10476,10527,42.9,21003,12.3,60575,90.8,2.3
27047,23825,15247,15199,44.6,30446,11,48943,88.9,2.9
27049,36210,23396,23280,43.2,46676,7.7,66038,93.3,3.2
27051,4596,2979,2977,44.6,5956,12,51274,92.8,2.9
27053,959394,623382,609101,36.3,1232483,10.9,71184,92.8,3.7
27055,14749,9430,9384,45.3,18814,8.5,58201,93.6,2.7
27057,16311,10222,10496,48.7,20718,13.1,49129,92,2.5
27059,29713,19254,19771,39.7,39025,7.7,68303,91.2,4.3
27061,35679,22368,22874,46.1,45242,13.3,51644,93.3,3.5
27063,7766,4867,5077,44.5,9944,8.7,58849,92.2,2.3
27065,12436,7820,8010,44.9,15830,13.2,51347,88.5,4.7
27067,32302,21172,21323,39.8,42495,11.5,53034,88.2,2.6
27069,3408,2162,2171,48.2,4333,11,50012,91.8,1.7
27071,10278,6291,6337,49.4,12628,14.3,49393,91,4.4
27073,5393,3322,3393,50,6715,9.7,49669,92.9,2.2
27075,8678,5211,5414,50.7,10625,9.1,62746,95.4,2.3
27077,3127,1848,1966,50.9,3814,10.9,47584,89.7,2.5
27079,20968,13673,13918,41.1,27591,8.4,63451,90.8,3.1
27081,4469,2852,2931,46,5783,12.7,46405,91.7,2
27083,19206,12856,12843,35.9,25699,12.8,52989,92.4,3.1
27085,27463,18009,17833,41,35842,7.4,58393,91.1,2.7
27087,3755,2704,2761,36.2,5465,17.5,41640,87.1,6.4
27089,7200,4584,4740,43.7,9324,9.8,54651,89,2.7
27091,15533,10035,9794,45.4,19829,12.1,48326,90.1,2.1
27093,17498,11347,11763,42.2,23110,7.1,61374,92,2.6
27095,19686,12858,13008,41.5,25866,12.1,53407,89.9,4
27097,25089,16250,16571,41.9,32821,11.9,51422,89.4,3.1
27099,29370,19509,19654,39.2,39163,13.2,53302,87,3.8
27101,6545,4167,4162,47.4,8329,9.3,52373,90,2.7
27103,26150,16669,16906,36.2,33575,8,66868,93.6,2.5
27105,16006,10603,11245,36.1,21848,11.6,56069,77.3,4.8
27107,5068,3279,3300,44.4,6579,12.1,49572,90.3,2.1
27109,115346,78201,74901,37,153102,8.6,72511,94.3,3
27111,45494,28879,29206,46.7,58085,10.5,51252,91.7,2.5
27113,10944,7105,7130,39,14235,9.8,52724,91.5,2.3
27115,23075,13462,15412,44.7,28874,12.2,50962,89.1,3.7
27117,6884,4697,4505,42.3,9202,10.9,51050,86.2,2.7
27119,24117,15704,15956,38.8,31660,14.5,50893,91.1,2.7
27121,8757,5424,5625,46.3,11049,9.1,58892,93.5,2.3
27123,414181,277048,263601,34.8,540649,13.9,60287,90.3,4.5
27125,3024,1980,2027,42.9,4007,9.8,50625,92.1,2.7
27127,11559,7638,7625,42.6,15263,9.1,54918,88.5,2.2
27129,11412,7226,7434,45,14660,9.9,56724,88.5,2.2
27131,51320,32109,33513,36.7,65622,9.7,67726,90.1,3
27133,7140,4863,4701,41.6,9564,9.4,57518,90.1,1.4
27135,11834,7594,8032,41.6,15626,7.8,55879,91.2,1.5
27137,161728,99627,100353,40.6,199980,14.7,50156,93.5,3.6
27139,103309,72014,71666,36.3,143680,5.5,91046,94.9,3.1
27141,68454,45487,48041,36,93528,6.3,83304,94.5,3
27143,11318,7358,7469,41.8,14827,9.1,60978,89.8,3
27145,120032,77034,78618,34.5,155652,11.7,57881,92.1,3.4
27147,27513,18531,18274,39.5,36805,9.1,60619,92.4,3
27149,7656,4864,4829,33.1,9693,11.1,58179,91.6,2
27151,7269,4653,4766,43.6,9419,10.2,50954,88.6,2.2
27153,18450,11787,12446,43.6,24233,12.5,46255,87.8,2.7
27155,2670,1693,1663,49.2,3356,12.7,50416,90.7,2.7
27157,16580,10663,10610,44.3,21273,7.6,63115,93.2,2.3
27159,10406,6927,6834,42.7,13761,14.6,40963,89.3,3.1
27161,14455,9881,9030,39.7,18911,9.3,53383,92,3.1
27163,190252,128125,124992,39.2,253117,4.5,90755,96,2.8
27165,8286,5475,5433,41,10908,11.3,49482,84.9,1.9
27167,4938,3097,3261,43.4,6358,8.9,54373,92.3,1.3
27169,41648,25691,25257,34.7,50948,11.5,56499,92.5,4
27171,94929,65658,66892,36.6,132550,5.3,76256,94.2,3.3
27173,7646,4920,5015,43,9935,9.9,55690,90.6,2.1
28001,24661,15424,15824,41.2,31248,31.4,32956,80.8,4.7
28003,28565,19091,18213,39.9,37304,16.9,38675,81.4,4.3
28005,9848,6426,6032,46.4,12458,24,34986,76.6,5.2
28007,14154,9987,8947,40.4,18934,23.8,31722,76.9,5.7
28009,6458,4192,4072,42,8264,25.3,36400,76.2,7.2
28011,24642,17455,15282,35.1,32737,35.3,29633,74.8,7.6
28013,11090,7626,6984,41.4,14610,21.9,34417,74.6,5
28015,8231,5068,5187,45.3,10255,17.4,39622,80.8,4.3
28017,12960,8822,8424,37.8,17246,22.2,34611,72.9,5.9
28019,6368,4228,4014,42.9,8242,23.1,36194,81.5,6.8
28021,7129,4803,4336,32.4,9139,38.2,29266,77.6,8.5
28023,12322,8431,7457,42.2,15888,20.9,37814,80.2,5.6
28025,15272,10491,9359,39.6,19850,23.9,34408,78.8,7.7
28027,17325,12853,10956,34.6,23809,41.2,26815,77.5,12.3
28029,21760,14802,13680,38.2,28482,27.1,34450,77.9,7.6
28031,14728,10056,9513,38.4,19569,23.5,33348,79.4,7.1
28033,129685,90826,84785,36.6,175611,10.2,64138,89.2,4.7
28035,58558,39875,36104,32.7,75979,25.4,36709,86.2,7.6
28037,5902,3957,3825,42.2,7782,20.2,37533,84.2,5.5
28039,17448,11742,11953,36.7,23695,16.1,50705,80.3,4.4
28041,10667,5747,7661,38.3,13408,24.1,39559,75.2,4
28043,16250,11151,10124,39.9,21275,22.5,37419,77.3,5.2
28045,36609,23759,23032,43,46791,17.2,45369,84.3,5.1
28047,153817,103175,100059,36.2,203234,20.5,42988,86.4,5.7
28049,181708,128623,112606,34.5,241229,20.8,42903,86.3,6.5
28051,13216,9445,8554,34.1,17999,42.5,22045,74.4,8.6
28053,6179,4530,3983,36.3,8513,38.9,25506,65.3,13.2
28055,1122,543,751,40.1,1294,40.5,26957,66.5,3.7
28057,18364,11925,11604,39.8,23529,18.1,40644,75.8,3.8
28059,107416,71784,69457,38.6,141241,17.6,53288,87.7,5.1
28061,12758,8501,8077,41.4,16578,22.7,34806,83.2,3.3
28063,5635,3693,3604,38.3,7297,33.7,26731,78.5,4.6
28065,9080,5947,5438,43.8,11385,26.9,30815,79.8,7.1
28067,50578,34893,33060,37.4,67953,20.5,40283,80.5,4.1
28069,7925,4955,4941,40.5,9896,28.3,31018,77.8,4.4
28071,44071,27601,26195,29.9,53796,20.7,42287,89.4,4.2
28073,45574,31655,29259,35.3,60914,12.6,57419,92.1,5.6
28075,59171,40118,37637,38,77755,23.7,40949,86.2,5.1
28077,9611,6474,6275,39.7,12749,19.7,42291,79.3,5.5
28079,16644,11004,11616,36.6,22620,24.9,35644,76.7,5.3
28081,63629,44460,40921,37.3,85381,17,43834,83.4,4.3
28083,21688,15847,14009,33.4,29856,35.6,27573,77.5,6.2
28085,26134,18043,16480,39.2,34523,20,39701,85.9,4.2
28087,45554,31236,28366,36.9,59602,21.2,44142,84.1,6.7
28089,78632,54909,50205,37,105114,12,65870,90.3,3.7
28091,19292,13014,12237,39.7,25251,27,33416,77.8,4.5
28093,27998,18098,17703,40.4,35801,23,37561,78.5,4
28095,27537,18701,17172,41.1,35873,19.4,38208,78.6,5.2
28097,7868,5343,4844,43,10187,24.2,34946,74.9,4.3
28099,21033,15379,14024,36,29403,22.5,37195,78.6,5.1
28101,16127,11226,10332,37.8,21558,21.7,37468,83.5,4.9
28103,8258,5783,5255,37.1,11038,31.6,29330,69,8.5
28105,40955,24879,24954,25.5,49833,28.3,36105,86.8,6
28107,25479,17685,16479,37.4,34164,22.7,35570,79.7,5
28109,42646,27946,27364,40.7,55310,18.6,43654,83.6,6
28111,9390,6266,5979,40.9,12245,21.4,38064,80.7,4.9
28113,29128,20897,18770,37.2,39667,30.1,32485,79.3,4.8
28115,23147,16004,15546,36.5,31550,18.4,41455,76.7,4.3
28117,19533,12883,12373,38.9,25256,24.2,36558,76.4,4.8
28119,5559,3859,3490,39.8,7349,34.3,26210,67.6,13.3
28121,114257,77742,72486,37.7,150228,9.5,62284,90,3.2
28123,20695,14460,13747,36.5,28207,22.6,34452,72.8,6.9
28125,3414,2400,2152,40.9,4552,35,27880,74.7,12.6
28127,20329,13820,13092,39.2,26912,23.1,39568,80.4,5.8
28129,12149,8243,7666,41.2,15909,18.9,38521,81.3,2.1
28131,14036,8915,9097,37.9,18012,20.3,41884,82.8,4.5
28133,20277,12550,13857,35.2,26407,35.1,29529,72.5,9.6
28135,11505,6368,8026,36.6,14394,37.2,29233,67.3,4.7
28137,21593,14624,13577,37.6,28201,17.2,45643,79.8,4.5
28139,16731,11286,10904,38.6,22190,24.8,38571,77.2,6.1
28141,15198,10016,9475,43.2,19491,17.6,37909,78.5,5.6
28143,7205,5437,4797,33,10234,31.3,30241,78.1,6.7
28145,21205,14486,13825,38.2,28311,13.1,44880,76.4,5.1
28147,11140,7594,7005,40.1,14599,24.1,32016,77.3,4.3
28149,35676,24737,22403,38.8,47140,24.1,41162,86.7,4.1
28151,34818,25273,21958,36.4,47231,34.2,30187,76.9,11.3
28153,15449,10606,9874,38.6,20480,25.3,35545,75.6,5.2
28155,7479,4969,4798,40.6,9767,20.7,39192,85.2,5.4
28157,7085,4249,4798,38.7,9047,35.1,26390,69.4,3.8
28159,13847,9272,8888,40.6,18160,23,36091,78,6.4
28161,9605,6488,5983,42.2,12471,22.9,35312,78.4,2.8
28163,20657,12263,15001,35.5,27264,34.8,31773,76.6,8.2
29001,20670,13220,12139,28,25359,23.8,36819,89.9,3.6
29003,13376,8746,8604,41.8,17350,9.7,53356,90.6,2.8
29005,4226,2688,2605,47.1,5293,12.8,45966,90,2.4
29007,20036,14209,11812,39,26021,17,42463,84.5,4.4
29009,27695,17780,17952,43.7,35732,21.4,38060,82,6
29011,9036,6018,5890,41.7,11908,16.1,40349,86.4,3.2
29013,12500,8316,8101,41.7,16417,13.8,42133,85.3,3.3
29015,15569,9403,9436,53.6,18839,17.9,36413,85.2,4.2
29017,9352,6048,6004,43.6,12052,17.4,40935,78.8,2.3
29019,140860,90917,85677,30.9,176594,16.6,52824,93.7,3.1
29021,68719,44028,44910,37.5,88938,17.8,47517,87.2,4.1
29023,32649,21969,20770,40.2,42739,22,35494,83.2,5.4
29025,6892,4483,4579,42.2,9062,12.7,44952,90,2.5
29027,35524,21991,23087,38.3,45078,11.6,53186,85.7,3.2
29029,36334,22421,22076,50.8,44497,16.8,47373,88.2,4.4
29031,62021,40661,38252,36.4,78913,15.2,50227,90.2,3.7
29033,6900,4545,4368,43.7,8913,16.6,44581,85.9,5
29035,4718,3171,2997,42.4,6168,21.2,33283,79.9,5.2
29037,77625,52639,50206,39.7,102845,8.7,64422,92.5,3.8
29039,10707,7013,7003,45,14016,19.8,35998,84.4,5.1
29041,5790,3755,3761,45.8,7516,13.3,44229,87.7,2.1
29043,62675,43088,41313,37.8,84401,10.7,54273,91.1,4.1
29045,5180,3337,3386,43.9,6723,15.5,43975,86.5,2.7
29047,180449,121749,117336,37.1,239085,8.4,65973,92.7,3.6
29049,15734,10272,10338,41.8,20610,10.4,58371,92.5,3.2
29051,59282,37876,38755,38.5,76631,10.9,55767,91.3,3.1
29053,13837,8437,9275,38.9,17712,14.7,47187,89,3.1
29055,18612,12228,12074,41.9,24302,18.6,41139,78.3,6.6
29057,6030,3764,3867,46.8,7631,17.5,37884,86.5,4.7
29059,12614,8252,8196,43.7,16448,18.6,36178,81.4,5.4
29061,6063,4054,4155,40.9,8209,16.9,43519,84.1,2.7
29063,10515,4677,7936,41,12613,15.7,46835,85.9,2.2
29065,11926,7709,7678,44.4,15387,19.8,38722,78.9,4.2
29067,10505,6704,6654,47.4,13358,19.8,33121,80.1,3.3
29069,22741,15897,14638,39.6,30535,27.2,33237,73.9,4.1
29071,78929,51778,51060,40.8,102838,10.7,55496,87.2,3.8
29073,11697,7417,7391,46.3,14808,12.1,48593,86,2.9
29075,5007,3455,3206,41,6661,14.6,42402,89.3,3.4
29077,228355,147710,140980,35.9,288690,16.5,42802,91.2,3.6
29079,7738,5273,4892,40.7,10165,17.1,40303,87.1,2.6
29081,6446,4345,4211,42.7,8556,18.1,39021,85.3,2.1
29083,16794,10990,10604,44.2,21594,20.7,42607,87,3.9
29085,7653,4714,4555,54.2,9269,19.3,33649,81.8,5
29087,3552,2253,2195,47.3,4448,14.1,42240,90.4,2.8
29089,7859,5063,4995,39.4,10058,15.9,48518,88.3,2.9
29091,30580,20605,19605,40.7,40210,20.5,36323,84.7,3.8
29093,7906,5024,4998,44.7,10022,22.4,34133,80.8,5.3
29095,526045,357130,334671,36.6,691801,15.5,50822,89.8,4.4
29097,89002,61112,57999,36,119111,17.5,44699,87,3.9
29099,171305,112791,111435,39.4,224226,10.1,61508,87.5,4.9
29101,42327,26101,27841,29.8,53942,14.4,50257,91.4,4.3
29103,2992,1960,1974,44.4,3934,18.9,36770,86.2,3.5
29105,26705,18031,17459,40,35490,15.7,40885,81.8,4.9
29107,25122,16453,16165,42,32618,12.7,52065,88.9,3.5
29109,28708,19356,19025,40.1,38381,14.9,41934,84.1,4.1
29111,7865,5059,5075,38.9,10134,16.9,43813,87.8,3
29113,41079,27582,27685,37.3,55267,11.2,56833,87.2,5.1
29115,9279,6277,5887,42.5,12164,16.1,41176,88.2,2.1
29117,12043,8570,6665,41,15235,17.6,41759,86,2.5
29119,16708,11148,11472,38.2,22620,21.4,37594,78.2,3.4
29121,11616,7713,7457,43.7,15170,16.3,40603,87.4,4.9
29123,9581,6345,6098,41.9,12443,18,36909,80,3.4
29125,6985,4432,4426,45.1,8858,15.2,43192,82.6,5.1
29127,22161,14862,14032,39.7,28894,14.5,45187,87.1,3.7
29129,2826,1840,1859,44.9,3699,13.6,42239,88.8,2.7
29131,19243,12633,12573,41.5,25206,16.3,41274,84.9,4
29133,10842,6353,7446,40,13799,28.4,32388,72.8,5.4
29135,12041,7498,8520,37.9,16018,11.6,50241,83.6,2.7
29137,6682,4225,4333,45.6,8558,15.4,41630,89.7,3.4
29139,9015,5801,5819,44.5,11620,15.6,42701,83.8,4.3
29141,15693,10030,10183,46.7,20213,19.6,38412,77.8,4.6
29143,13766,9338,8577,41.6,17915,25,33037,75.9,6.2
29145,44506,29506,29188,40.1,58694,14.3,46170,85.6,3.6
29147,18957,11328,11342,29.3,22670,17,44923,92.6,3.3
29149,8283,5477,5312,45.6,10789,24.9,30126,83.6,2.7
29151,10535,6577,7087,41.2,13664,8.6,55781,90.3,2
29153,7481,4618,4619,51.5,9237,25.3,32042,83.8,4.2
29155,12581,8973,8100,37.8,17073,30.9,33293,74.8,6
29157,14698,9695,9590,40.7,19285,10.3,51922,87.5,2.8
29159,31679,21368,20845,37.4,42213,15.2,42089,83.1,4
29161,35212,21253,23355,35,44608,19.6,40738,87,3.5
29163,14373,8261,10177,39.6,18438,18,43617,80.4,3
29165,74877,49676,48633,38.2,98309,6.1,77933,95.3,3.2
29167,24062,15959,15326,38,31285,16.8,44357,86.5,5.3
29169,40950,22637,30017,27.4,52654,14.2,50870,89.9,4.4
29171,3770,2405,2448,46,4853,17.5,40150,88.5,1.5
29173,8018,5032,5192,44.7,10224,10.9,51564,87.9,4.1
29175,19548,11880,13109,38.8,24989,16.1,43386,86.4,3.9
29177,17597,11413,11341,42.6,22754,11,57589,88,4.8
29179,5173,3114,3341,46.9,6455,22.1,33487,76,4.5
29181,10628,7052,6765,42.5,13817,27.7,30796,78.2,4.2
29183,297702,198654,192264,38.1,390918,5.2,80696,94.3,3
29185,7474,4592,4680,49.3,9272,20.7,35683,81.1,4.1
29186,13967,8888,9142,42.9,18030,11.7,57701,87.5,2.7
29187,52402,31034,35593,39,66627,16.3,42851,82.2,3.8
29189,776916,524651,473930,40.3,998581,9.2,62756,93,4.4
29195,17671,11525,11455,38,22980,15.9,43095,84.6,3
29197,3248,2221,2173,39.4,4394,19.8,38134,86.7,3.6
29199,3524,2472,2460,36.9,4932,16.1,39399,82.8,3.1
29201,29506,19858,18887,39.5,38745,18.4,41738,83,3.9
29203,6377,4107,4061,45.4,8168,26.4,29499,81.7,4.5
29205,4631,3059,3023,42.3,6082,16.6,40679,90.6,3.7
29207,22980,15053,14535,42.1,29588,19.1,37694,80.4,4.5
29209,25760,15866,15181,53,31047,12.9,43092,86.7,4.1
29211,4836,3038,3224,42.6,6262,17,40770,83.8,2.3
29213,43043,28178,26557,41.7,54735,17,38268,88.2,4.4
29215,20182,12309,13466,42.5,25775,29.9,33879,82.1,3.4
29217,15718,10579,10144,40.2,20723,17.5,39036,87.4,2.8
29219,25612,16870,16932,40.6,33802,11.8,54756,85.8,4
29221,19136,12082,12757,41.1,24839,22,35745,77,5.6
29223,10452,6657,6482,47.4,13139,26,30793,75.3,4.3
29225,27794,18693,19413,37.4,38106,16.7,46989,86,3.1
29227,1612,1032,992,48.4,2024,14.2,41338,89.1,2.6
29229,13640,9303,8983,41.5,18286,24.2,32722,79.3,4.7
29510,249517,160688,150716,35.3,311404,24.3,39954,84.5,6.9
30001,7740,4599,4802,42.1,9401,14.4,40218,93.7,4.3
30003,8772,6742,6601,30,13343,25.5,39445,86.3,10.5
30005,4609,3358,3243,34.1,6601,24.3,36852,89.4,8.9
30007,4590,2819,2928,48.1,5747,10.6,50791,93.6,3.3
30009,8592,5134,5326,49.9,10460,10.3,53794,93.9,2.3
30011,976,602,601,52,1203,13.8,47280,92,1.6
30013,63431,40427,41328,38.2,81755,14.2,45569,91.7,3
30015,4417,2890,2869,41.3,5759,15.7,40718,93,1.9
30017,9357,5929,5995,42,11924,11.4,48935,91.4,1.4
30019,1370,866,889,48,1755,10.3,49333,94.8,1.3
30021,7210,4489,4838,39.8,9327,11.2,55312,92.5,1.4
30023,7725,4246,4839,48.2,9085,18.6,38394,89.5,1.8
30025,2286,1519,1601,38.2,3120,8.5,54158,96.2,2.1
30027,9026,5598,5815,46.2,11413,14.6,45520,93.1,1.8
30029,76418,49183,48899,42.3,98082,12.3,50249,94.5,4.1
30031,83318,50492,54010,33.4,104502,11.4,60439,96.8,3.8
30033,1020,640,670,42.8,1310,13.8,43328,93.7,0
30035,9421,6993,6701,31.9,13694,28.3,37207,89.8,5.7
30037,668,406,425,51.7,831,18.3,38276,93.4,1.5
30039,2826,1653,1715,54.5,3368,13.1,43469,89.5,3.5
30041,11990,8180,8362,34.3,16542,19.5,41705,90.5,3.2
30043,9465,5868,5985,48,11853,8.8,62734,94.9,3.7
30045,1578,923,1017,51.6,1940,13.4,44607,94.9,1.7
30047,22517,15065,14693,42.4,29758,19.2,40888,90.6,5
30049,52744,33974,33308,41.5,67282,10.4,60370,94.9,2.7
30051,1882,1248,1161,43.2,2409,20.2,38535,79.2,3
30053,15724,9497,9762,52.7,19259,18.7,37793,88.1,5.5
30055,1350,843,857,47.9,1700,15.6,46001,93.1,0.6
30057,6680,3817,4107,53.8,7924,11.2,51252,94.5,2.4
30059,1500,891,936,52.2,1827,18.3,39284,92.5,1.8
30061,3443,2033,2151,53.6,4184,17.8,39933,87.4,3.2
30063,93752,57734,58396,35.6,116130,15.2,47086,95,4.9
30065,3672,2297,2292,50,4589,17.4,42103,90.2,3.1
30067,13096,8026,8088,46.8,16114,11.7,45405,95.4,2.5
30069,398,225,264,50.1,489,15.1,43230,97.8,2.6
30071,3180,2050,2083,45.7,4133,15.5,42550,91.3,4.1
30073,4646,3102,2982,42.6,6084,18.4,39984,89.2,5.1
30075,1446,876,870,51.6,1746,10.7,47996,94.9,3
30077,5794,2614,4244,45.4,6858,17.5,44863,88.6,0.6
30079,946,578,604,51.4,1182,12.1,43592,93.1,3.8
30081,33854,21288,20800,48.8,42088,13.8,44851,91.1,4.3
30083,8515,5548,5934,36.8,11482,7.5,65277,92.2,1.8
30085,7548,5636,5669,30.5,11305,23.9,40129,84.9,3.1
30087,6546,4573,4714,35.7,9287,16.6,53946,88.3,6.2
30089,9459,5602,5932,53.6,11534,17.6,38486,88.1,4.4
30091,2878,1784,1864,45,3648,10.6,49112,91.3,1.7
30093,27464,17148,17405,40.5,34553,15.5,45231,90.8,4.4
30095,7386,4596,4810,47.2,9406,8.4,59905,95,2.4
30097,2873,1774,1849,47.9,3623,9.8,49666,94,0.2
30099,4626,3057,2999,44.2,6056,14.1,46185,92.9,3.3
30101,4041,2141,2836,41.8,4977,16.8,42689,84.1,0.6
30103,565,339,353,52.9,692,10.3,50770,92.2,0
30105,5846,3750,3789,44.8,7539,12.5,47028,93.5,3
30107,1631,1045,1072,46.3,2117,19,37360,75.9,1.7
30109,857,541,552,48.5,1093,10.9,47908,87.9,1.6
30111,121245,80497,77940,38.3,158437,8.8,57351,93.1,2.5
31001,24162,15829,15855,38,31684,12.7,48010,90.9,3.6
31003,4838,3160,3169,45.4,6329,11.3,48799,91,1.1
31005,343,236,233,38.4,469,11.9,44511,95,2.3
31007,635,400,398,52.8,798,12.5,51049,96,5.4
31009,384,233,251,50.3,484,15.5,48974,98.7,0.7
31011,4084,2654,2678,43.9,5332,10.1,52844,93.5,1
31013,8338,5622,5572,39.5,11194,11.5,56537,91.5,2.9
31015,1586,1002,980,52.3,1982,14.7,41461,94.8,0.6
31017,2326,1529,1431,47.2,2960,13.8,44709,92.5,0.2
31019,37768,24718,24665,32.9,49383,11.2,57036,93.6,2.4
31021,5112,3311,3235,46.8,6546,10.7,51054,89.9,1.6
31023,6181,4008,4044,44.2,8052,8.9,55285,91.1,3.1
31025,19532,12801,12966,41.9,25767,7.6,63707,94.7,2.3
31027,6503,4297,4374,43.7,8671,9.4,53864,92.8,1.3
31029,2957,2002,1935,42.7,3937,9.3,51695,88.9,1
31031,4510,2890,2942,43.4,5832,11.9,48933,91.2,1.7
31033,7652,5006,5045,39.6,10051,9.4,52565,93.7,1.7
31035,4663,3011,3152,43,6163,11.3,51712,89.6,1.8
31037,7228,5027,5387,33.7,10414,9.8,50901,71.5,4
31039,6811,4492,4524,43.1,9016,8.7,56419,87.7,1.7
31041,8270,5450,5357,43.6,10807,11.6,47199,92.3,1.5
31043,14579,10186,10279,34.1,20465,12,53332,74.3,4.9
31045,7356,4507,4472,33.7,8979,16.9,44496,94.4,1.2
31047,17111,11554,12086,36.3,23640,12.7,51688,75.9,3.3
31049,1483,953,920,49.2,1873,11.5,48546,90.9,3.2
31051,4325,2830,2932,42.1,5762,8.5,52436,88.5,2.3
31053,28018,18588,18169,40,36757,11.7,51704,87.6,2.9
31055,411633,281241,273754,34.5,554995,12.4,59226,89.4,3.5
31057,1471,917,914,47.7,1831,12.4,43459,90.2,2.2
31059,4585,2873,2847,47.5,5720,9.8,53037,91.7,1.8
31061,2442,1507,1507,50.4,3014,13.3,45456,91.2,2.1
31063,2101,1288,1333,44.1,2621,12.5,55089,95.4,1.6
31065,3722,2422,2365,46.5,4787,14,44219,88.2,2.3
31067,16963,10975,10824,44.3,21799,11.3,44166,89.3,2.4
31069,1565,933,997,51.4,1930,16.3,38701,94.4,1.4
31071,1632,1.00E+03,1011,52.4,2011,12.8,44016,94.3,2
31073,1528,949,1022,45.9,1971,9.8,55373,93.1,3.3
31075,502,309,332,47.5,641,10,55830,97.4,3.2
31077,1842,1199,1200,47,2399,14.3,45429,93.2,1
31079,44878,30618,31087,35.8,61705,12.7,52315,83.2,3.8
31081,6956,4604,4582,41.4,9186,7.7,63996,93.5,1.4
31083,2712,1684,1789,49,3473,12.1,45626,91.4,1.1
31085,729,435,462,53.3,897,16.8,46401,90.8,1.1
31087,2181,1405,1420,46.5,2825,12.9,43502,91.8,1.7
31089,7709,5188,5062,44.4,10250,10.6,54055,92.2,0.9
31091,550,364,344,51,708,8.2,47526,94.1,1
31093,4873,3166,3263,43,6429,10.5,54803,92.4,2.3
31095,5625,3592,3585,46.5,7177,10.7,47750,89.3,2.1
31097,4150,2114,3057,41.1,5171,12.6,47592,88.4,1.6
31099,4958,3292,3260,41.5,6552,9.1,66321,93.4,2.5
31101,6381,3992,4026,47.6,8018,12.8,46431,91.8,2.5
31103,635,403,388,52.6,791,16.1,47282,93.3,0.5
31105,2861,1838,1841,46,3679,13,45091,88.4,3.3
31107,6477,4376,4195,45.9,8571,12.9,46647,91.6,2
31109,238395,154530,155107,33.4,309637,12.2,58873,93.4,3.1
31111,27027,17961,17589,40.4,35550,9.4,57445,91.9,2
31113,560,367,405,39.9,772,10.3,50979,90.5,0.6
31115,479,286,305,52.9,591,16,47918,97.3,0.2
31117,380,254,239,47,493,12.2,49265,93.5,0
31119,26371,17693,17322,37.1,35015,14.3,49625,88.3,2.2
31121,6013,3907,3921,42.3,7828,10.4,52112,92.5,3.7
31123,3614,2363,2424,41.8,4787,16.5,44398,86.7,2.3
31125,2759,1799,1777,44.3,3576,12.5,47579,90.7,2.1
31127,5470,3519,3452,38.2,6971,13.4,49242,94.4,4.2
31129,3402,2142,2123,49.4,4265,12.5,41840,93.3,1.9
31131,12312,8119,7962,42.5,16081,9.5,55030,91.1,2.6
31133,2068,1337,1315,48.5,2652,15.4,42389,90.7,1.7
31135,2172,1421,1477,42.8,2898,10.6,59732,89.1,1.2
31137,7013,4628,4638,41.5,9266,9.2,57432,93.1,0.8
31139,5395,3538,3621,41.8,7159,9.6,55586,94.8,2.7
31141,24238,16308,16553,37.6,32861,9,59288,89,3.3
31143,4016,2605,2598,45.3,5203,8,53881,94.1,2.6
31145,8345,5320,5402,41.3,10722,10.7,48783,93.5,3.4
31147,6361,4054,4006,47.4,8060,12.4,45256,91,2.9
31149,1115,683,707,52.1,1390,13.8,48802,92.5,1.1
31151,10825,6979,7352,35.8,14331,11.5,51222,83.6,2.2
31153,129295,89446,89577,34.4,179023,5.8,74374,95.4,2.7
31155,15907,10396,10642,41.7,21038,7.4,66330,93.1,2
31157,27328,18694,17728,39.1,36422,15.9,46641,87,3.5
31159,13204,8446,8838,37.6,17284,7.9,66102,92.8,2.3
31161,4066,2663,2571,46.4,5234,16.2,41128,89.8,1.3
31163,2400,1556,1498,49.8,3054,12.3,43657,92.5,1.4
31165,992,600,642,49.5,1242,15.5,48891,94,0
31167,4460,2904,3040,39.7,5944,7.6,57857,91.9,2.3
31169,3951,2572,2529,47.3,5101,11.2,48668,91.8,0.9
31171,547,345,371,42.9,716,13.9,49449,93.4,1.3
31173,4549,3638,3489,27.9,7127,25.3,43737,86.6,9.5
31175,3227,2112,2072,45.6,4184,11.6,43405,92.7,1.3
31177,15623,10363,10240,41,20603,7,70727,95.7,1
31179,7474,4633,4732,31.1,9365,12,52764,94.9,1.6
31181,2827,1820,1783,46.4,3603,12.9,41616,91.9,1.9
31183,612,385,391,47.3,776,11.4,46838,95,0.4
31185,10583,7079,6715,39.8,13794,10.5,53960,94.3,0.9
32001,18608,11948,12250,40,24198,14.2,50292,89.4,6.3
32003,1648781,1080353,1075311,37.1,2155664,14.6,54455,84.9,6.2
32005,39624,23917,24103,51.5,48020,9.7,61988,93,4.1
32007,37714,25015,27153,33.7,52168,10.4,70242,83.4,3.5
32009,666,358,432,51.6,790,14.8,48693,89.2,6.2
32011,1480,894,1023,44.1,1917,9.9,67590,91.6,2.5
32013,12177,8049,8793,35.2,16842,11.9,68999,82.4,5.4
32015,4199,2805,2897,36.5,5702,11.9,71814,82.9,5.5
32017,3934,2327,2728,42.3,5055,14.1,49874,88.6,4.3
32019,41597,26164,27015,43.8,53179,11.9,51344,85,6.5
32021,3620,2274,2175,49.1,4449,18.2,41892,86.5,7.2
32023,36062,21234,22189,52.6,43423,15.9,48001,84.7,6.5
32027,5401,2337,4223,42.1,6560,17.5,56984,78.2,1.4
32029,3549,1980,2071,55.8,4051,7.8,60066,94,2.2
32031,353949,225574,228042,38.2,453616,12.5,58253,87,5.3
32033,7648,4074,5608,39.5,9682,14.7,54832,83.8,3.8
32510,43622,26758,27984,43.5,54742,13,52253,87.3,5.6
33001,49374,30819,29960,47.1,60779,10,57779,91.7,3.3
33003,39526,23792,23497,51.9,47289,10.5,56836,93.3,3
33005,62153,38718,37056,42.9,75774,8.6,57286,92.7,3.3
33007,26694,15073,16966,48,32039,13.8,45127,87.9,3.9
33009,74002,45048,43840,43.1,88888,10.3,60335,92.2,2.9
33011,322267,205066,202695,40.8,407761,8,75997,91.6,3.6
33013,119571,75367,73215,43.2,148582,7.4,69320,93.1,3.2
33015,242690,153011,150240,44.4,303251,4.2,82016,94.8,3.6
33017,103268,65235,62193,37.1,127428,7.7,69467,92.3,3.8
33019,34662,21806,21198,46.2,43004,9.5,58021,90.4,2.8
34001,212113,139795,131196,41.3,270991,14.2,55672,85.7,7.8
34003,737851,484076,455075,41.7,939151,6.9,93205,92,3.8
34005,354493,227907,221377,41.5,449284,6.2,80081,92.9,5.2
34007,392861,263681,246469,38.5,510150,12,65838,88.3,5.8
34009,77662,48118,46312,49,94430,11.9,59181,90.1,5.4
34011,117137,74978,78819,37.1,153797,18.4,48867,77.3,5.5
34013,607372,413551,383363,37.3,796914,16.3,54879,84.7,8
34015,226675,150097,142233,40.1,292330,7.8,79332,92,5.5
34017,539252,340487,337496,34.9,677983,15.6,63157,83.4,5.6
34019,99494,63136,61540,46.2,124676,4.5,113336,94.7,3.6
34021,291147,189431,181592,38.5,371023,11.1,76988,87.7,5.6
34023,654471,425057,412016,38.4,837073,8.6,82183,89,4.6
34025,490490,321182,304664,43.1,625846,7.1,89968,92.7,4.5
34027,390254,253879,244544,42.4,498423,5.4,107019,94,3.8
34029,452382,306839,285658,42.9,592497,11,62276,90.9,4.5
34031,385445,260374,247571,36.9,507945,17.2,61517,82.5,4.5
34033,49575,32500,30936,42.5,63436,12.6,56071,86.6,5.8
34035,258801,170823,162928,41.6,333751,5.2,104668,94.1,3.7
34037,113196,71661,70861,44.6,142522,6,87549,93.9,5
34039,424329,284740,270890,38.3,555630,10.6,71801,85.8,5.8
34041,84717,54413,52204,44,106617,8.3,74834,90.4,5.6
35001,525146,344957,331996,37.4,676953,16.2,50599,88.1,4.6
35003,3070,1671,1837,60.5,3508,23.2,34868,92.3,1.4
35005,47796,32714,32568,35.2,65282,22,40573,78.1,4
35006,20750,13468,14019,36.9,27487,26.9,36651,80.1,8.7
35007,9971,6019,6234,49,12253,21.4,38426,88.7,5.7
35009,36834,24163,26117,31,50280,18.9,43450,83.2,5.2
35011,1387,914,879,46.6,1793,21.2,32820,85.9,2.8
35013,160459,108909,105298,33,214207,25.6,38287,79,6.4
35015,42362,28546,29075,35.2,57621,15.2,57287,84.5,3.6
35017,22441,14331,13949,46.8,28280,22.8,39750,86,4.7
35019,3480,1882,2494,39.7,4376,25.1,31547,75.9,0.1
35021,568,316,349,57,665,14.3,37027,89,2.7
35023,3346,2149,2153,44,4302,26.7,33605,76.9,6.1
35025,48490,33916,35833,31.6,69749,18,52213,71.8,4.1
35027,15878,9864,9565,51.9,19429,18.2,41214,89.5,3.3
35028,13965,8952,9195,42.9,18147,4,114670,97.2,1.7
35029,18026,12213,12237,38,24450,27.6,28227,69.3,7
35031,52261,38838,36085,31.3,74923,34.4,31505,73.8,7.9
35033,3666,2215,2289,49.6,4504,25.2,34602,87.7,0.9
35035,50130,31644,33766,35.7,65410,20.5,41995,83.7,5.5
35037,6588,4293,4072,47.2,8365,24.6,28996,83.5,1.2
35039,30356,20470,19570,40.4,40040,22.5,37174,84.2,4.9
35041,14426,9517,9565,30.3,19082,22.3,37122,79.8,6.3
35043,108026,72361,69664,39.6,142025,14.5,58621,90.8,5.1
35045,85376,57990,57089,36.3,115079,17.4,50847,83.5,5.9
35047,22394,14002,13758,43.4,27760,25.7,31734,81.8,2
35049,120690,76568,72083,46.1,148651,14,57469,88.3,4.1
35051,9436,5603,5588,56.6,11191,27,30467,82.8,4.5
35053,13146,8386,8641,39,17027,25.4,33239,79.7,2.7
35055,26944,16893,16172,48.4,33065,22.4,34075,87.7,5.6
35057,11981,7294,8008,43.1,15302,27.3,36347,82.3,4.5
35059,3415,1799,2384,41.3,4183,20.1,37787,78.4,1.4
35061,57548,37495,38131,39.3,75626,18.6,43819,81.7,5.7
36001,251100,159442,149404,37.7,308846,12.1,61634,92.7,3.8
36003,37486,23140,23937,39,47077,18.4,45226,89,4.6
36005,1087594,769135,686585,33.6,1455720,28.6,37355,71.2,7.5
36007,157108,99342,95992,39.7,195334,16.5,49927,90.2,4.3
36009,60081,39079,38598,41.6,77677,14.6,46224,88.2,4.4
36011,62156,37950,39911,42.6,77861,12.5,53437,87.6,4.2
36013,102806,65357,64147,42.3,129504,19.2,42664,88.2,4.5
36015,67650,43504,42818,41.2,86322,15.2,50722,90.2,3.2
36017,38387,24238,24341,44.6,48579,15.2,45193,86.9,4
36019,66523,39419,41654,40,81073,14.4,53392,86.4,3.7
36021,50122,30402,30587,47.8,60989,12.7,57579,88.9,3.4
36023,38781,24596,23474,36.4,48070,16.4,51810,90.4,3.3
36025,37566,22604,22919,47.5,45523,17.5,45381,87.8,4.6
36027,237366,147739,146734,42,294473,9.2,73680,90.1,4.9
36029,732231,474770,446276,40.2,921046,14.2,54175,90.8,3.8
36031,31822,18245,19857,47.2,38102,12.6,50506,89.6,4.3
36033,40549,22707,27702,40.1,50409,18.4,49062,85.4,4.5
36035,42984,27053,26775,43.9,53828,15,45982,86.7,4.8
36037,46467,29383,29099,43.1,58482,11.4,54211,90.9,3.5
36039,39493,22710,24798,46,47508,16.4,49860,85.9,4
36041,3900,2270,2272,54.6,4542,10.2,52134,86.3,4.7
36043,49412,31662,30951,43.6,62613,16.3,49633,90.2,5.4
36045,86512,54030,59976,32.7,114006,15.3,46206,90.2,5.1
36047,2020035,1382169,1246981,34.8,2629150,20.6,54793,80,5.7
36049,20650,13244,13621,41.8,26865,15.8,48314,89.1,4.7
36051,52688,31943,32314,40.6,64257,13.9,54256,89,2.9
36053,57397,36271,35058,41.5,71329,11.1,57703,90.4,2.9
36055,589725,386813,360914,38.9,747727,14.7,54684,90.4,4.7
36057,38050,24983,24293,41.2,49276,19.9,42193,84.5,5
36059,1065350,700236,661264,41.6,1361500,6.1,105486,90.9,3.8
36061,1403397,864411,779323,36.9,1643734,17.2,77214,87,4.6
36063,168938,108538,103220,43.1,211758,12.6,50328,90.9,4.4
36065,182131,115988,115202,41.2,231190,16.3,52404,88.1,4
36067,365633,241133,225061,39,466194,14.6,56853,90.5,4.3
36069,87270,55947,53881,43.6,109828,9.6,58320,92.6,3.5
36071,282037,189291,189919,36.9,379210,12.6,71963,89.4,4.2
36073,33103,20782,20564,42.7,41346,15.2,50750,86.3,4.2
36075,93584,59348,59639,39.9,118987,17.2,52621,86.5,5.4
36077,50315,30910,29187,42.1,60097,14.7,50034,90.5,4
36079,78645,49568,49332,44.1,98900,6,96267,92.7,4.1
36081,1856646,1201496,1131558,38.3,2333054,13.3,61844,80.7,5
36083,128078,81008,79062,39.8,160070,11.6,63174,91.3,4.4
36085,371113,245463,230552,39.7,476015,13.2,75524,88.9,3.6
36087,235952,166663,160117,36.1,326780,14.4,84358,87.3,4.6
36089,87741,53826,56212,38.4,110038,17.5,50897,88.1,5.4
36091,179980,114708,112345,42.3,227053,6.3,75904,94,3.6
36093,120919,79191,75362,39.8,154553,11.4,57923,90.2,4.7
36095,25558,15642,15675,44.6,31317,12.7,50244,88.5,5.9
36097,14646,9099,9.00E+03,46.4,18099,15,48109,90,4.2
36099,27733,16522,18255,41.9,34777,13.5,48998,85.5,3
36101,75721,48657,48283,42.8,96940,13.2,50190,89.6,4.5
36103,1169320,758243,734340,41.5,1492583,7.6,92310,90,3.9
36105,58811,36347,38454,42.6,74801,16.9,49016,86.2,6
36107,38186,24542,24218,44.2,48760,12.7,55643,90.2,4.1
36109,89263,53231,51640,30.7,104871,18.5,55778,94.5,3.1
36111,146799,90280,88945,44,179225,13.9,61421,90.1,5.3
36113,52554,32989,31578,46.3,64567,11.7,55769,91.2,3.8
36115,49925,29749,32051,43.7,61800,11.1,51052,88.5,4.9
36117,71060,45812,44986,43.5,90798,10.4,58521,90,4.4
36119,755253,502748,471794,40.7,974542,10,89380,87.6,4.6
36121,33067,18531,22260,42.4,40791,10,56089,88.1,4.2
36123,19361,12825,12098,41.3,24923,14.1,48820,85.2,4.4
37001,123656,83799,75889,39.9,159688,16.1,46060,84.7,4.3
37003,29769,18414,19014,44,37428,15,46385,80.6,4.7
37005,8916,5452,5396,49.3,10848,20.6,35965,81,3.4
37007,20473,12059,13389,40.8,25448,25.1,35809,80.4,8
37009,22046,13633,13291,48.3,26924,16.1,39709,83.3,4.3
37011,14812,8.00E+03,9516,44.4,17516,19.7,38098,79,3.7
37013,37618,24796,22730,45.8,47526,19,41431,84.6,5.4
37015,16350,9699,10155,44.9,19854,24.4,33809,74.8,6.8
37017,26551,17645,16096,44,33741,26.4,33621,78.4,4.5
37019,106163,65702,61251,52.9,126953,13.8,51457,88,5
37021,207570,133352,122736,42,256088,13.5,50538,90,3.7
37023,71529,44753,44098,44.4,88851,17.7,41383,79.6,6.1
37025,149213,103549,98041,37.8,201590,11,63059,88.9,5.4
37027,64513,41089,40360,44.1,81449,17.1,39166,77.6,6
37029,7990,5193,5225,41.9,10418,8.7,65415,83.2,6.7
37031,56394,35061,33829,47.9,68890,12.3,51557,90,5.3
37033,18571,11272,11638,46.1,22910,19.7,40570,75.1,5.5
37035,121052,79871,76588,41.5,156459,12.7,49475,83.4,4.9
37037,57921,37739,34504,47.8,72243,11.7,63303,86.9,4.4
37039,23001,14344,13561,50.8,27905,18.4,37237,84.2,3.4
37041,11438,7561,6822,46.3,14383,18.9,41151,84.2,7.2
37043,9007,5573,5342,52.5,10915,15.3,37581,88,5.3
37045,75643,50495,46649,41.7,97144,20.6,38654,83.5,7.2
37047,44286,28497,28008,41.6,56505,24.6,35290,80.7,4.2
37049,80686,51113,52332,36.7,103445,15.3,49524,87.3,5.4
37051,244028,166824,160303,31.8,327127,18.8,45286,90.3,6.2
37053,20043,13016,12793,42.8,25809,10.2,57570,87.2,3.9
37055,29074,18230,17734,46.5,35964,10.9,56371,92.5,4
37057,127903,84404,80522,42.6,164926,15.4,46263,82.4,6
37059,32946,21560,20453,45.1,42013,11.6,54189,85.5,3.8
37061,44520,30081,28888,40,58969,21.3,38771,72,6.3
37063,240196,160224,145988,35.2,306212,16.1,54255,87.4,4.3
37065,40999,28658,24660,41.2,53318,23.9,34612,77.4,7.1
37067,284180,195079,176432,38.1,371511,17.5,48987,87.9,5.2
37069,50253,32551,32154,41.6,64705,15.3,49484,83.2,4.9
37071,167236,112187,104778,40.1,216965,15.7,48874,83.2,6
37073,9077,5848,5630,45.5,11478,15.2,45755,85.3,5.7
37075,6741,4305,4253,45.4,8558,19.9,35763,79,4.4
37077,46787,28972,30059,42.6,59031,15.2,50414,81.6,3.8
37079,16702,9593,11575,40.1,21168,23.7,39738,75.1,5.7
37081,403729,274081,247249,37.4,521330,18.3,47754,88.4,4.8
37083,40664,26960,24806,43.5,51766,27,33044,76.8,6
37085,95818,65984,64897,34,130881,16.1,51106,85.8,5.5
37087,49601,31506,29176,47.5,60682,15.9,45290,87,3.2
37089,92089,59281,54928,47.2,114209,12.2,53638,88.7,2.6
37091,19413,12187,11949,41.7,24136,26.1,35424,80.3,6
37093,38288,26879,26383,32.4,53262,19.5,46004,84.6,6.1
37095,4587,2466,3051,44.1,5517,22.3,37881,80.6,7.9
37097,132293,87775,85141,40.5,172916,10.6,56325,87.9,5.5
37099,34970,21499,20742,37.6,42241,20.9,44004,86.8,2.8
37101,141728,97659,93791,38.2,191450,13.2,55174,85,4.9
37103,7987,5070,4775,48,9845,21.5,38873,81.5,6.1
37105,44986,30557,29059,38.8,59616,16.9,46723,81,5.8
37107,44346,29952,27355,42.4,57307,20.6,39341,80.3,7.4
37109,63602,40830,40338,43.2,81168,12.7,50714,83.9,5.6
37111,35834,22521,22554,43.9,45075,18.4,41443,82.4,5.2
37113,27866,17682,16694,49.5,34376,16.4,41140,87.7,3
37115,17372,10764,10576,44,21340,18.8,40765,82.5,4.1
37117,18432,12279,10893,46.5,23172,22.5,35561,83.7,7.2
37119,799737,548403,506432,35,1054835,12.3,63197,89.6,5.6
37121,12348,7708,7418,48,15126,16.4,42530,81.7,3.3
37123,21176,14086,13332,42.5,27418,21.4,40371,76.4,4.7
37125,75531,49762,46014,44.8,95776,11.4,54545,89.6,3.9
37127,72916,48901,45104,41.6,94005,16.5,47403,84.1,5.8
37129,181065,116601,106882,38.8,223483,17.3,51373,92.3,5
37131,16325,10280,9720,48.9,2.00E+04,22.4,35711,78.3,6.1
37133,139973,85726,101410,27,187136,13.7,47163,91,5.8
37135,113201,74139,67657,34.2,141796,12.8,65299,92.4,3.9
37137,10798,6270,6551,51.9,12821,18.5,43927,86.7,4.4
37139,31026,20398,19466,38.1,39864,17,43687,85.4,4.8
37141,45949,29594,29496,42.7,59090,15,50437,85.5,5.8
37143,10776,6931,6404,48.8,13335,16.9,45052,84.9,5.7
37145,30845,20246,19038,43.8,39284,15.4,47974,84.7,7.9
37147,138429,93822,83398,32,177220,21.5,45918,88.8,7.5
37149,16914,10605,9729,52.5,20334,14.5,47185,87.8,4.2
37151,110282,72699,70717,41.7,143416,14.4,45939,80,4.3
37153,34615,23005,21934,40.3,44939,24.9,35367,80.3,6.2
37155,99116,69128,64107,36.2,133235,27.8,34439,76.4,5.6
37157,72455,47374,44019,44.7,91393,18.1,41620,81.1,5.4
37159,108602,70940,68993,40.7,139933,16.5,47971,83.9,6.2
37161,52444,34359,32062,44.8,66421,18.6,38699,81,5.3
37163,47574,32121,31003,40,63124,19.6,41477,75.7,5.6
37165,27113,17735,17509,39.3,35244,27.6,35138,78.6,6.2
37167,47487,30558,30233,42,60791,13.1,49106,84.7,6.3
37169,37182,23436,22661,46,46097,12.4,48148,82.2,4.3
37171,56464,3.70E+04,35113,43.8,72113,17,38843,77.6,3.3
37173,11118,7420,6926,41.3,14346,16.7,38996,80.3,3.7
37175,28089,17273,16209,51.4,33482,16.6,44578,88.2,3.4
37177,3371,1887,2254,41.9,4141,27.3,33666,73,6
37179,163921,115086,111520,38.1,226606,9,72548,89.2,4.6
37181,33653,23607,20637,40.5,44244,24.2,34717,76.3,6.2
37183,790036,538241,508550,36,1046791,9.2,76173,92.3,4
37185,16196,9965,9942,47.2,19907,26.4,36285,79.2,4.6
37187,9691,6497,5698,47,12195,26.1,35367,79.3,8.4
37189,46883,26918,27004,31.2,53922,24.3,44014,88,5
37191,94532,63255,60895,37.5,124150,20.6,42421,83,6.8
37193,54378,34861,33879,44.8,68740,16.8,41640,76.9,5.4
37195,62536,42949,38712,40.4,81661,22.3,41352,80.2,5
37197,29522,18928,18604,44.2,37532,14,46276,78.1,3.8
37199,14341,8997,8681,47.5,17678,19.1,39686,83.4,4.9
38001,1859,1165,1140,49.9,2305,9.6,48596,96,1.3
38003,8716,5425,5501,43.2,10926,10.9,53704,90.9,1.8
38005,4391,3265,3474,29.9,6739,29.4,40787,85,3.4
38007,743,423,511,41.6,934,8.9,71697,90.1,2.1
38009,5171,3154,3425,44.5,6579,11.1,54444,90.8,1.5
38011,2452,1591,1650,41.1,3241,8.2,59668,89.8,1.5
38013,1641,1036,1162,40.8,2198,9,63787,88.9,1.2
38015,72667,47012,47475,36.7,94487,7.2,66406,93.4,1.6
38017,136018,86316,88933,32,175249,10.7,59711,94.5,2.2
38019,3045,1862,1965,50,3827,9.7,52880,91,0.7
38021,3854,2541,2523,41.8,5064,10.9,54044,87.7,1.8
38023,1897,1181,1232,47.2,2413,10,60315,88.2,1.1
38025,3363,2026,2340,38.3,4366,9.8,67375,91,2.4
38027,1834,1171,1187,48,2358,10.1,55196,89.1,1.4
38029,2679,1635,1711,50.9,3346,13.9,44646,84.8,1.9
38031,2588,1663,1640,45,3303,8.9,54218,88.7,0.8
38033,1380,902,915,41.6,1817,9.8,56795,92.4,0.3
38035,56425,34567,36516,29.4,71083,13.9,51820,93.7,2.4
38037,1889,1192,1185,51.1,2377,15.6,39822,88.7,1.6
38039,1858,1102,1175,52.8,2277,9.6,49350,87.6,1
38041,2034,1365,1264,43.7,2629,10.5,50158,87.9,1.5
38043,1907,1157,1257,46.6,2414,12.6,47914,91,1.1
38045,3215,1995,2116,48.3,4111,11.6,52563,86.3,1.1
38047,1512,942,999,48.7,1941,12.7,50841,84.4,1.1
38049,4532,2877,3086,42,5963,10.9,53719,90,1.7
38051,2172,1361,1295,53.3,2656,12.1,42950,81.6,0.7
38053,8705,5892,6729,30.8,12621,7.9,77733,92.4,2.6
38055,7652,4741,4988,45.8,9729,9.2,60684,91.5,0.9
38057,6718,4175,4519,42.9,8694,6.6,80072,90.6,1.7
38059,23659,15269,15540,37.4,30809,8.9,65021,92.1,1.6
38061,7565,4683,5559,33.5,10242,9.5,63736,91.9,2.8
38063,2431,1444,1516,53.1,2960,11.6,45233,91.7,0.5
38065,1410,914,956,44.7,1870,10.3,65920,87.9,1.4
38067,5615,3398,3671,46.8,7069,9.1,59244,88.9,2
38069,3320,2111,2156,44.6,4267,13,44291,88.3,0.9
38071,8867,5745,5802,40.6,11547,14.1,51481,90.9,0.7
38073,4163,2641,2763,44,5404,8.1,56550,90,1.5
38075,1960,1219,1331,43,2550,8.2,57392,92.2,0.6
38077,12838,7951,8402,37.5,16353,10.2,59556,91.4,1.9
38079,9649,7407,7252,30.5,14659,26.7,40595,84,2.8
38081,3082,1824,2066,45,3890,7.7,59464,91.7,0.6
38083,1084,646,676,52.8,1322,16.9,38977,86.9,2.2
38085,2764,2243,2226,26.3,4469,35.3,33550,85.7,11.1
38087,599,362,401,48.3,763,11.3,54040,88.6,0
38089,23095,14832,16367,33.5,31199,8,78604,90.6,2.4
38091,1566,950,1012,48.4,1962,8.3,61808,94.1,2.7
38093,16810,10341,10787,40.6,21128,11.2,53769,89.9,1.7
38095,1769,1114,1149,49.6,2263,10.7,50987,92.3,3
38097,6208,3968,4062,41.4,8030,8.4,55068,92.2,1.7
38099,8433,5397,5507,44.1,10904,11,51481,86.9,2.2
38101,53702,32890,37320,31.1,70210,8.8,61089,93.3,1.6
38103,3289,2042,2056,51.1,4098,10.5,51677,84.8,1.3
38105,24846,15853,18484,31.6,34337,6.8,81719,92.3,1.5
39001,21178,14026,13881,41.6,27907,20.2,38302,78.2,5.1
39003,79566,51350,52392,38.7,103742,15.5,47924,89.3,4.8
39005,41456,27283,26369,40,53652,12.2,50612,87.4,3.5
39007,76376,48676,49555,42.6,98231,18.2,43668,85.4,4.5
39009,56357,33152,33034,28.8,66186,28.8,38131,89.7,5
39011,34852,23093,22801,41.1,45894,9.2,59543,92.8,2.7
39013,55599,33571,35102,44.1,68673,15.7,45661,89.9,4.4
39015,33726,22027,21732,42.1,43759,16.7,51504,85.3,4.7
39017,287652,192528,185009,36.7,377537,12.4,63094,89.7,4
39019,21850,13791,13878,45.1,27669,12.8,48616,87,3.9
39021,29922,19391,19356,41.8,38747,11.1,56203,89.1,4.5
39023,104137,69396,65390,41.5,134786,15.7,47410,87.2,5.4
39025,155109,102853,100169,39.9,203022,10.6,61203,89.6,3.3
39027,31983,21144,20758,39.4,41902,13.4,53234,88.5,4
39029,82213,51311,52374,44,103685,17.2,46873,87.6,5
39031,27929,18475,18127,41.6,36602,12.7,45777,85.7,3.8
39033,32886,21511,20572,43.2,42083,13.9,44336,88.5,4.4
39035,984603,653875,595477,40.2,1249352,18.3,46703,88.5,6.2
39037,39347,26261,25517,42,51778,10.7,52771,88.9,3.8
39039,29363,19240,18918,40.3,38158,10.4,52210,89.8,4.4
39041,143296,99209,97254,38.6,196463,4.7,102990,96.6,1.9
39043,59656,38493,36614,44.7,75107,12.5,51354,90.6,4.8
39045,116023,76663,75934,39.5,152597,9.7,65198,91.7,3.8
39047,21962,14565,14111,40.6,28676,16,44257,87.4,4.1
39049,966556,647359,617159,34,1264518,16.6,56090,90.4,4.4
39051,32312,21474,21040,41.1,42514,8.9,56504,90.4,4.1
39053,23076,15203,14812,40.8,30015,20.6,42074,80.5,3.7
39055,71996,47532,46528,44.6,94060,5.8,77938,91.1,2.6
39057,130803,83692,81073,38.4,164765,12.1,62751,92.6,4
39059,30331,19660,19403,42.3,39063,18.6,43519,84.5,5.4
39061,621065,419005,390094,36.8,809099,16,53344,90.1,5.2
39063,58682,38661,37211,39.1,75872,10,56406,92.5,3.6
39065,24164,15839,15635,36,31474,13.3,46969,89.4,5
39067,12078,7735,7572,45.7,15307,16.8,44274,85.9,2.5
39069,21220,13987,13642,41.6,27629,8.3,57752,91.3,3.4
39071,32692,21908,21121,40.8,43029,19.8,44729,83.9,5.4
39073,22020,14328,14012,42.8,28340,14.5,47799,88.4,5.4
39075,29751,21916,22020,31,43936,11.7,58783,58.5,2.2
39077,44316,29566,28873,40.1,58439,12.2,51278,87.7,4.3
39079,24793,16563,15942,40.1,32505,18.1,45168,84.2,6.5
39081,53626,34312,32392,44.5,66704,16.3,43558,89.9,4.4
39083,46924,30990,29824,39.3,60814,12.7,53375,89.6,3.7
39085,182041,116850,111764,44,228614,8.6,61946,91.9,3.5
39087,47440,31190,29682,41.9,60872,17.9,42132,85.7,4.1
39089,131756,87622,84576,39.9,172198,11.7,58902,90.4,4.3
39091,34516,22814,22351,41.3,45165,12.2,53760,89.6,3.7
39093,237558,155263,151102,41.4,306365,12.4,54951,89.2,5.1
39095,332501,222589,209899,38,432488,19.8,45251,88.8,6
39097,34315,20033,23386,40.5,43419,11.8,60039,86.7,3.6
39099,183339,117713,112295,43.7,230008,18.7,42839,90.1,5.3
39101,51507,30392,34704,41.2,65096,14.8,44783,86.6,4.2
39103,136587,89581,87640,42.1,177221,6.5,73148,93.6,2.8
39105,18155,11772,11353,43.7,23125,21.1,39070,84,5.9
39107,30507,20344,20565,39.5,40909,8.2,57577,91.8,3.2
39109,80577,53170,51509,41.6,104679,9.5,59591,89.1,4.1
39111,11261,7087,7123,46.2,14210,15.2,44062,87.5,3.2
39113,413044,275259,255980,39.3,531239,18.2,47239,89.6,5.4
39115,11642,7379,7425,44.6,14804,18.7,40680,87.7,4.2
39117,26676,17474,17562,41.7,35036,12.2,52953,86.1,3.4
39119,66336,44283,41785,40.2,86068,14.8,44871,86.5,4.5
39121,11631,5933,8361,51.5,14294,15.1,48836,84.1,2.4
39123,32984,20507,20129,48.9,40636,10.4,56569,92.3,3.2
39125,14409,9473,9392,41.7,18865,10.7,51020,90.2,3.8
39127,27317,17931,17996,40.2,35927,17,47543,83.9,5.5
39129,45001,27182,30383,39.3,57565,13.2,60051,87.1,3.5
39131,21378,14095,14065,40.8,28160,20.5,42869,78.1,5.6
39133,131248,82416,79505,38.1,161921,13.5,52947,91.9,5.2
39135,31814,20795,20452,42.4,41247,11,57896,88.8,4.2
39137,25312,17017,17039,39.5,34056,8.3,61069,92.9,2
39139,94944,59488,61619,41.5,121107,15.8,44835,87.2,4.6
39141,60463,36611,40389,41.2,7.70E+04,18.6,47507,85.7,5.3
39143,45802,30008,29322,41.8,59330,11.6,52452,89.3,4
39145,59492,38503,37585,40.4,76088,22.1,39245,84.1,4.4
39147,43048,27707,27646,39.8,55353,12.9,49546,90.8,4.2
39149,36210,24221,24402,39.4,48623,9.4,59604,90.7,3.9
39151,292382,192279,181333,41.9,373612,13.2,51036,90.4,4.8
39153,425043,278003,262297,40.9,540300,13.7,52226,91,4.7
39155,159940,103286,98539,44.2,201825,17.6,45929,88.9,3.9
39157,71404,46740,45680,41.7,92420,12.7,50273,85.9,3.6
39159,41663,28953,26504,37.7,55457,6.1,78796,91.9,2.4
39161,21755,14432,13930,41.4,28362,8.9,52610,91.5,3.7
39163,10025,6444,6477,42.1,12921,20.8,41522,80.8,6
39165,169930,113041,114022,39.4,227063,5.4,81543,92.9,3.3
39167,48604,30767,29843,44.2,60610,13.7,47802,90.2,2.6
39169,88021,58651,57819,38.5,116470,11.9,53605,85.4,2.7
39171,28567,18694,18323,41.7,37017,9.7,50770,88.6,3.6
39173,103551,65908,64311,35,130219,11.4,60347,94.1,4.2
39175,17059,11165,10953,41.9,22118,8.6,55590,90.3,3.6
40001,16181,11069,11029,37.2,22098,29,33632,79.5,3.1
40003,4650,2338,3489,43.2,5827,15.8,53695,88.5,2
40005,10632,6611,7199,39.9,13810,19.9,36766,81.8,4
40007,3975,2684,2698,39.9,5382,11.6,53493,84.2,1.9
40009,16894,10401,12118,35.1,22519,17.1,47407,84.5,1.8
40011,7044,4903,4740,40,9643,17.7,44229,85,1.2
40013,34814,23300,22273,37.2,45573,16.9,39219,86.1,4.1
40015,22002,14074,15483,37.1,29557,21.3,40296,85.8,4.5
40017,100605,68709,67823,35.8,136532,8.4,68291,91.8,2.9
40019,36255,24942,23614,38.2,48556,16.4,47966,86.5,3.6
40021,37723,24750,23950,35,48700,23.2,36297,85.7,4.1
40023,11336,7684,7201,41.7,14885,26.8,32458,80.6,4.3
40025,1637,1052,1110,45.2,2162,17.7,4.40E+04,84.5,1.2
40027,217137,139504,139151,33.8,278655,12.4,61275,91.3,3.2
40029,4331,2877,2774,41.8,5651,21.9,41111,82.9,4.9
40031,92823,58896,63240,32.8,122136,16.2,48493,89.6,5
40033,4579,2975,2966,42,5941,16.9,43019,87.7,5.5
40035,11372,7158,7467,42.2,14625,17.5,42781,85.6,2.8
40037,54183,35978,35334,40.2,71312,15.5,45630,86.3,2.7
40039,21987,14655,14638,31,29293,18,43247,87.9,2.3
40041,33058,21065,20533,46.6,41598,17.7,39144,84.5,4.2
40043,3568,2455,2364,39.8,4819,13.2,49398,90.5,1.5
40045,3120,2080,2.00E+03,42.5,4080,13,51745,87.9,3.2
40047,46428,31263,31340,35.8,62603,14.6,49841,87.2,3
40049,20748,14016,13822,38.5,27838,17.5,40978,84.7,2.1
40051,41416,27362,27293,38.8,54655,13.2,55552,87.7,2.5
40053,3375,2231,2234,43,4465,13.3,48118,91,2.3
40055,4788,2568,3430,39.1,5998,26.7,35231,85.8,2.9
40057,2042,1392,1312,41.2,2704,26.1,36703,77,5.2
40059,2742,1854,1863,39.7,3717,10.6,48559,82,1.2
40061,9689,6376,6371,41.3,12747,21.1,36418,80.4,4.2
40063,10671,6284,7282,40.2,13566,24.7,33578,79.7,3.4
40065,18938,12731,12766,34.1,25497,19.2,44211,82.5,3.2
40067,4736,3084,3146,41.9,6230,22.2,37105,83.9,3.7
40069,8408,5589,5498,39.6,11087,21.9,38080,81,3.5
40071,33628,22632,22311,38.6,44943,16.6,44391,87,4.4
40073,11362,7825,7813,37.5,15638,10.4,60814,88.3,2.4
40075,6954,4573,4504,42.1,9077,22.3,36069,84.6,3.4
40077,8130,5143,5271,41,10414,21,35942,84.1,4.3
40079,37840,24878,24995,39.2,49873,21.6,37005,81.8,4.1
40081,26518,17707,17422,41.1,35129,15.8,44914,85.1,3.5
40083,35780,23501,23087,38.8,46588,14.5,54305,90.3,3.5
40085,7501,5052,4945,38.7,9997,13.9,45200,83.2,2.1
40087,28856,19514,19168,38.5,38682,10.8,61730,88,2.5
40089,24404,16727,16095,38.9,32822,25.7,32664,81.6,3.4
40091,15869,10013,9802,47.9,19815,21.2,36903,84.3,4.9
40093,5755,3952,3820,40.2,7772,12.1,51607,87.9,3.6
40095,12405,8135,8056,43,16191,15.7,41669,80.3,3
40097,31110,20533,20387,40.2,40920,17.5,45922,86.2,3.6
40099,10668,6959,6959,42,13918,13.4,48008,82.8,1.8
40101,52475,35570,33907,37.9,69477,21.4,40581,85.5,4.1
40103,8681,5723,5661,41.7,11384,13.4,50316,88.5,2.9
40105,8076,5269,5150,42.1,10419,17.4,41800,85.7,4.4
40107,9321,5631,6536,39.9,12167,25.1,35106,79.1,4.7
40109,581035,399876,383094,34.5,782970,16.3,51082,86.4,3.6
40111,29799,19887,19326,38.8,39213,20.7,38446,87.3,5.7
40113,37087,23783,24023,42.7,47806,15.5,46074,88,3.7
40115,23764,16167,15524,38.4,31691,19.1,39210,83.8,4.5
40117,12543,8254,8231,41.5,16485,16.6,44619,87.6,3.3
40119,65447,39680,41451,26.7,81131,25.1,42035,91.2,3.3
40121,34295,21699,22474,40.4,44173,14.4,44520,86.1,3.2
40123,29175,19667,18663,35.6,38330,16.3,44212,88.5,3.7
40125,54863,37658,34632,37.7,72290,18,42453,86.5,4
40127,8661,5600,5457,45.3,11057,22,34222,82.2,4.9
40129,2688,1826,1814,40.8,3640,13,54629,91.9,0.9
40131,69768,46069,45697,39.3,91766,9.1,62622,91.3,3.3
40133,18825,12854,12353,38.8,25207,22.6,36671,83.8,4.1
40135,31574,20914,20380,40.6,41294,19.6,39629,81.5,4.6
40137,33684,22690,21400,40.8,44090,16.7,44505,86.9,3.8
40139,15218,9768,11330,32.5,21098,13.9,50993,71.7,2.1
40141,5630,3718,3747,40.3,7465,23.6,36350,77.7,3.1
40143,479058,329511,313429,35.5,642940,15.7,51476,88.8,4.2
40145,58331,39182,38497,38.6,77679,11.3,61882,89.6,4
40147,39862,26723,25364,40,52087,14.3,52283,90.8,2.9
40149,8513,5752,5695,38.5,11447,16,45642,88.1,1.7
40151,7313,4296,4905,33.3,9201,13.5,50441,87.9,1.6
40153,15580,9837,10977,36.5,20814,12.5,57403,87.4,2.6
41001,12899,7945,8114,48.1,16059,17.6,42177,90.4,4.6
41003,74632,44585,44800,32.8,89385,18.4,56167,95,4.6
41005,319103,207487,200575,41.4,408062,8.7,74460,93.3,4.3
41007,31145,19551,19081,43.8,38632,12.9,49898,91.9,4
41009,39883,25430,25355,43.3,50785,11,63055,90.4,4.9
41011,51888,32420,31341,48.1,63761,17.5,41403,88.9,5.4
41013,18179,11374,11196,48.1,22570,14.2,45350,87.6,6
41015,19369,11557,11156,55.9,22713,14.1,40682,89.7,4.9
41017,143764,91867,89440,42.6,181307,10.6,61248,93,4.3
41019,87462,55065,53392,47.3,108457,15.6,43202,89.1,5.5
41021,1490,908,946,51.2,1854,12.2,45728,89.9,5.6
41023,5836,3574,3584,52,7158,16,44309,89.6,3.9
41025,5761,3628,3664,45.6,7292,16.4,41846,89.6,8.2
41027,17494,11632,11600,38.8,23232,10.7,53941,80.3,3.1
41029,171858,110841,105686,42.9,216527,14.6,48538,88.9,5.1
41031,17605,11122,11958,40.5,23080,17.3,44943,83.5,7.1
41033,69083,43943,41961,47.9,85904,18,38921,88.8,5.1
41035,52039,33260,33183,42.2,66443,19,44678,87.6,6.1
41037,6386,3641,4196,47.9,7837,15.2,40095,83.9,4.3
41039,300021,187576,181943,39.5,369519,18.3,47933,91.1,5.2
41041,39573,24658,23148,51.4,47806,19.6,41791,89.3,3.4
41043,94818,62096,60753,40.1,122849,13.1,50876,89.7,5.7
41045,22706,13875,16564,36.4,30439,22.9,38130,80.1,4.8
41047,252284,168837,167479,36.4,336316,13.6,55954,85.1,5.6
41049,8106,5463,5811,36.8,11274,14.8,53588,75.1,3.6
41051,645168,403406,396360,37,799766,14.2,62292,90.7,5.3
41053,62984,42006,39817,37.3,81823,12.1,55218,91,5.9
41055,1388,846,864,49.4,1710,12.2,57216,93.3,4.1
41057,21126,12940,13203,47.7,26143,12.9,46226,89.8,3.7
41059,56790,36539,39917,36.2,76456,15.7,49667,82.6,5.4
41061,20291,13201,12886,38.7,26087,16,47309,92.6,3.8
41063,5645,3553,3393,52.4,6946,14.6,46350,93.2,4.2
41065,20270,13103,13012,41.6,26115,14.2,50562,85.8,4.2
41067,445230,295128,287651,36.7,582779,9,75577,90.8,4.5
41069,1147,668,676,57.4,1344,19.6,35341,91.6,4.9
41071,81315,52730,52305,38.4,105035,11.7,60643,88,4.9
42001,81461,51797,50383,44,102180,9.4,59645,87.8,3.5
42003,993353,633153,592212,40.7,1225365,11.5,56099,93.9,4.1
42005,53668,33459,33027,46.4,66486,13.8,46968,89.1,4.4
42007,134571,86161,81268,45.1,167429,9.7,54715,91.9,3.8
42009,38662,24172,24153,46.2,48325,13.7,44834,86.7,3.7
42011,320866,210777,204035,39.8,414812,13.1,59205,85.5,5.4
42013,98946,63691,60959,43.3,124650,13.6,44197,90.7,3.4
42015,47422,30601,30169,44.6,60770,11.5,50567,88.9,3.1
42017,495307,319122,307277,43.8,626399,6.6,80132,93.6,4.2
42019,148884,94433,92414,43.5,186847,7.3,66277,93.5,3.3
42021,108826,68524,66208,45.2,134732,15.6,43614,90.5,4.6
42023,3864,2357,2320,51,4677,14.2,39069,87.2,2.7
42025,51237,32037,31557,46.1,63594,13.1,51021,89.2,4.8
42027,136810,76570,84894,31.6,161464,17,59070,93.3,2.8
42029,396763,262156,254156,40.3,516312,7,92551,93,3.7
42031,31299,19677,18836,41.8,38513,15.2,44670,88.5,4
42033,65710,38460,42136,44.6,80596,14.1,46173,87.1,4.4
42035,31250,20044,19189,38.2,39233,17.8,46742,87.6,3.8
42037,54585,34390,32030,40.3,66420,13.5,48821,89,3
42039,67856,44032,42225,43.1,86257,14.4,45388,88.3,3.9
42041,197938,125480,123026,40.6,248506,7.9,64116,91.4,3.3
42043,212272,140806,132901,39.5,273707,11.3,59958,89.1,4
42045,438320,292437,270965,38.9,563402,10.8,67773,92.4,4.9
42047,24586,15192,15288,47.4,30480,10.1,49274,91.5,3.1
42049,216265,139704,136503,39.3,276207,15.7,48820,91.1,4.3
42051,107018,67050,65683,44.9,132733,17.5,42056,87.4,4.1
42053,6944,2363,4958,47.2,7321,24.6,38819,80.8,0.7
42055,119266,78204,75647,41.8,153851,9.1,59474,86.5,4
42057,11617,7236,7404,44.8,14640,10.6,47450,87,3.6
42059,30026,17886,19311,42.3,37197,15.7,50579,86.7,3.5
42061,36995,21376,24258,42.9,45634,13.6,46684,88.6,3.8
42063,70657,43128,43236,39.3,86364,20,43171,89,4.4
42065,34762,22173,21900,44.1,44073,13.3,42670,89.1,3
42067,19320,12427,12436,43.7,24863,10.2,49506,82.4,3.2
42069,168644,109078,102243,42.5,211321,14.1,47398,90,3.9
42071,410043,274708,263792,38.4,538500,10.7,61347,84.6,3.6
42073,69716,45026,42268,45,87294,13.7,46727,89.5,3.8
42075,106901,70699,68164,41.1,138863,9.9,56971,86,4.2
42077,280634,185898,177249,39.1,363147,13.8,60243,88.1,5.1
42079,254465,160090,156293,43.2,316383,14.6,46452,89.1,4.6
42081,91510,58683,56565,41.5,115248,14.6,48962,88.9,4.5
42083,33663,20244,21639,42.9,41883,17.4,43082,89.6,4.4
42085,90529,57163,55750,44.5,112913,16.1,49187,89.5,3.5
42087,36027,23568,22774,44,46342,14.7,43245,83.1,3
42089,132526,83903,82195,42.7,166098,12,59574,89.6,6.5
42091,643372,422295,399430,41.3,821725,6.2,84156,93.9,4
42093,14660,9509,8834,44,18343,11.2,54861,89.8,3.2
42095,241183,153446,148848,42.1,302294,9.3,65730,90.4,4.3
42097,74146,46066,46475,44.3,92541,14.6,46783,85.8,3.9
42099,35863,22622,23198,42.9,45820,9.1,59244,88.3,3.4
42101,1221665,825489,742383,34.1,1567872,25.3,41514,82.6,7.5
42103,45172,27678,27884,47.8,55562,9.8,60082,90.7,5.7
42105,13355,8446,8439,46.7,16885,14,44267,87.5,3.1
42107,115544,70211,73362,44.5,143573,12.8,50299,87.9,4.6
42109,31735,20461,20007,40.1,40468,12.7,52487,82.9,2.8
42111,61409,35968,39093,45.8,75061,14.1,43938,87.1,3.7
42113,5423,2927,3210,53.1,6137,12.8,43426,89,4.6
42115,33059,20304,20558,47.6,40862,12.7,47518,88.9,4.3
42117,33219,20892,20575,44,41467,13.3,49004,89.1,3.9
42119,37512,20377,25188,38.8,45565,11.8,57013,85.2,2.5
42121,42028,26636,25946,46.4,52582,14.6,41395,88.9,4.6
42123,32187,19947,20078,46.9,40025,15.3,43896,91.2,3.3
42125,167066,105967,102014,44.5,207981,9.7,58068,91.8,3.8
42127,42054,23732,26978,47.4,50710,13.7,49357,89.9,3.9
42129,289594,181829,173629,46.8,355458,9.8,56544,93,3.2
42131,22035,13700,13821,44.4,27521,11.3,55836,91.6,4.3
42133,345157,224396,219348,41.1,443744,9.8,62305,88.5,4.1
44001,39732,25386,23681,44.5,49067,8.2,70697,90.4,3.2
44003,133464,85342,79272,44.2,164614,9.6,63762,91.4,5
44005,68184,41816,40968,44.3,82784,9,72776,93.1,4.1
44007,502006,325559,308114,37.3,633673,15.8,52011,83.2,5.4
44009,104659,65242,61046,44.5,126288,9.8,7.70E+04,93.5,4.3
45001,19589,12821,12051,43.6,24872,15.3,40211,78.3,4.9
45003,130785,86407,81051,41.4,167458,17,47394,85.5,5.9
45005,7310,4248,4797,42.4,9045,38.2,26864,74.6,7.6
45007,151338,101941,94628,40.7,196569,15.4,45821,83.9,4.8
45009,11519,7471,6963,42.5,14434,28.4,32245,77.5,4.7
45011,16233,11244,10239,40.2,21483,22.6,41803,79.6,5.8
45013,147652,93127,90022,44.7,183149,10.3,65354,92.4,3.6
45015,159889,106081,104817,36,210898,12.3,58690,88.2,5
45017,11865,7665,7131,46.3,14796,16.2,41786,83.9,4.8
45019,317358,204593,191891,37.4,396484,15,56564,90.2,4.4
45021,43310,29029,27617,38.9,56646,18.6,38273,78.2,4.6
45023,24858,16592,15589,42.1,32181,19.8,39972,79.6,6.4
45025,35528,23630,22383,41.4,46013,20.5,39869,76.6,5.3
45027,27103,17210,16741,44,33951,24.9,34541,79.5,7.4
45029,29408,19703,18220,43,37923,23.4,35760,83.6,5.8
45031,51938,35460,31774,41.4,67234,21.1,37711,80.9,9
45033,22997,16213,14645,38.2,30858,25.6,31761,72.8,5
45035,115244,78870,74903,36.9,153773,9.5,58167,89.9,4.3
45037,21409,12177,14181,42.5,26358,17.7,46816,80.3,3.6
45039,18200,11823,10830,45.7,22653,21.2,36715,82.1,5.6
45041,105546,73967,64775,38.6,138742,18.3,45044,84.7,6.3
45043,49651,32194,29205,48.8,61399,15.2,47842,86,4.9
45045,382751,256648,242118,38.1,498766,10.9,55452,86.9,4.1
45047,53983,37403,32730,39.4,70133,21.7,40599,82.5,6.7
45049,15584,9692,10230,40.3,19922,22.3,35667,79.9,5.1
45051,262133,166585,155757,45.3,322342,15,45608,88.5,4.7
45053,22520,14003,14462,40.7,28465,20.7,41902,78.4,6.2
45055,49082,33045,31052,41.3,64097,15.6,48824,85.9,4.8
45057,69991,45998,43596,42,89594,13,53421,84.2,5.6
45059,52104,34496,32281,41.3,66777,18.2,43191,79.4,5.2
45061,14001,8636,8999,40.8,17635,27.7,32015,77.6,5.5
45063,219208,146835,139361,39.1,286196,11.7,57623,89.2,4.5
45065,8428,4425,5218,54.2,9643,18.1,43262,80.8,5.3
45067,24263,17101,14625,40.9,31726,25.2,31556,79.9,6.6
45069,21485,12762,14183,40.1,26945,28.1,32991,74.5,7.8
45071,29684,19472,18607,41.9,38079,18.9,42128,78.1,5
45073,60999,38777,37578,45.5,76355,14.6,46996,83.7,4.5
45075,68201,46734,41169,40,87903,22.7,34557,84.3,6.1
45077,98951,61612,61251,36.2,122863,14.9,46154,84.2,4.5
45079,321222,210781,198768,33.2,409549,16.4,51973,90.6,5.4
45081,15717,10018,10179,42.5,20197,16.7,43685,78.1,4.3
45083,231111,155325,146138,38.5,301463,15.6,47706,83.6,4.6
45085,81193,55488,51908,36.2,107396,20.4,41205,82.7,7.1
45087,21722,14528,13145,43.9,27673,21.2,39119,79.8,5.5
45089,25108,16588,15367,42.6,31955,29.8,28314,79.3,5.1
45091,195327,133767,124759,38.4,258526,10.7,61044,88.5,5.2
46003,2020,1305,1431,41.9,2736,10.4,50482,88.6,1.2
46005,13185,8964,9137,37.9,18101,14,48716,83.4,1.9
46007,2299,1782,1678,29.6,3460,33.8,33973,78.9,9.5
46009,5667,2877,4107,42.1,6984,14.6,48889,89,0.4
46011,27210,16667,17468,27,34135,14,58591,95.7,2.5
46013,29803,19807,19321,37.2,39128,10.6,53039,92.2,1.5
46015,3868,2647,2591,40.5,5238,12.7,49724,86.2,1.6
46017,1254,1022,1021,26,2043,39.5,22500,77.5,7.7
46019,7736,5098,5107,41.9,10205,13.9,44052,91,1.2
46021,1144,668,710,53.1,1378,9.6,47592,90.5,0.6
46023,6602,4728,4668,36.3,9396,21.7,41888,88.4,3.2
46025,2746,1805,1851,41.4,3656,11.6,45997,89.6,2.4
46027,11635,7099,6987,25.2,14086,20,42171,94.8,4.2
46029,21197,14013,14050,38.3,28063,11.8,50355,91.9,2.1
46031,2670,2054,2078,29.8,4132,39.1,31267,81.6,18.7
46033,7225,4332,4264,54.2,8596,10.6,51223,93.4,2.6
46035,15271,9968,9935,38.4,19903,10.8,50238,90.6,2.7
46037,4323,2725,2846,47.3,5571,14,43602,88.9,1.2
46039,3253,2034,2197,44.5,4231,9.8,53517,91.5,1.4
46041,3638,2922,2820,27.7,5742,27.5,38540,84.9,16.5
46043,2260,1494,1438,47.8,2932,11,48475,85.7,0.2
46045,3035,1957,1995,45.3,3952,10.1,55477,88.9,1.3
46047,5623,3412,3437,52.1,6849,12.9,44440,93.1,1.6
46049,1799,1167,1187,45.2,2354,13.8,47756,92.2,0.4
46051,5527,3445,3703,44.5,7148,9.9,55118,90.2,2.1
46053,3194,2005,2166,46.2,4171,15.9,38338,88.2,1
46055,1465,937,955,46.8,1892,11.2,47596,90.7,1.7
46057,4157,2964,3064,36.3,6028,9.5,57575,92.8,1.5
46059,2625,1657,1662,48.5,3319,9,52592,91.8,1.2
46061,2298,1672,1702,36.2,3374,8.8,61242,92.2,0.2
46063,972,590,688,41.3,1278,11.4,53080,93,0.9
46065,13426,8924,8676,39.1,17600,8.5,63468,91.2,1.6
46067,5561,3726,3642,43.9,7368,12.7,51786,86.9,3.4
46069,1079,668,684,48.5,1352,9.3,51053,93,1.4
46071,2211,1649,1677,30.1,3326,30.7,33881,87.4,9.5
46073,1522,1003,1001,45.9,2004,12.6,47468,88.7,0.4
46075,740,475,452,48.6,927,13,45485,91.7,1.6
46077,3910,2461,2540,46.1,5001,9.4,49653,90.6,1.4
46079,10343,6198,6711,45.6,12909,8.6,57473,94,2.6
46081,20677,12644,12637,42.1,25281,11.9,50488,94,2.1
46083,38911,27422,27047,34.8,54469,3.7,84610,95.1,1.4
46085,2760,1851,2043,34.9,3894,22.3,42682,88,4.5
46087,4127,2790,2835,40.7,5625,10,58975,89.3,1.6
46089,1873,1252,1186,48.8,2438,15.1,41253,78.8,3.4
46091,3715,2220,2581,42.5,4801,11,54019,89.1,1.3
46093,21174,13268,14425,35.8,27693,9.9,54976,93.4,1
46095,1452,997,1105,33.5,2102,33,33173,83.5,5
46097,1744,1111,1170,46.7,2281,12.2,46744,90.2,2.8
46099,139978,93060,94258,35,187318,9.9,60244,91.4,2.7
46101,4819,3185,3320,39.3,6505,10.5,55731,91,4.9
46102,8983,7328,7087,25.5,14415,40.7,30086,77.9,13.1
46103,83806,54269,55103,38.6,109372,14.5,51508,92.8,3.2
46105,2357,1500,1483,47.8,2983,12.7,46868,89.2,2.5
46107,1823,1176,1123,51.5,2299,9.8,54227,91.1,0.5
46109,7374,5113,5142,38.4,10255,17.9,43811,87.1,4.5
46111,1826,1142,1254,41.1,2396,11.7,51157,89.8,2
46113,,,,,,,,,
46115,4932,3200,3220,43.3,6420,11,49463,92.3,0.9
46117,2259,1462,1531,41.1,2993,7.9,66006,90.8,1
46119,1106,669,752,45.7,1421,7.2,54593,91.7,0.4
46121,6013,5215,4940,24.4,10155,48.6,29108,79.3,12.1
46123,4237,2756,2736,44.5,5492,17.3,45288,87.5,0.4
46125,6363,4138,4179,43.4,8317,9.2,58802,92.2,1.5
46127,11326,7369,7565,40.7,14934,6.6,74857,91.3,1.8
46129,4296,2838,2772,44.9,5610,14.8,47834,87.8,2.2
46135,17857,10877,11739,41.3,22616,11.8,54665,91.9,1.8
46137,1886,1409,1392,31.3,2801,43.7,30798,85.4,18.8
47001,60097,39031,36905,43.5,75936,14.4,46731,85.5,4.1
47003,35297,24141,23343,37.7,47484,14.7,47295,80.5,3.8
47005,12850,8118,7896,46.9,16014,17.9,35723,81.7,5.4
47007,12287,6101,8574,43.6,14675,23.8,37530,74.6,4.3
47009,102128,66238,62432,43.7,128670,11.4,51233,88.2,3.9
47011,81357,53762,50728,39.5,104490,14.2,45326,83.5,5.6
47013,31408,20277,19437,43.8,39714,24.1,34997,74.4,4.3
47015,11104,7094,6933,43.3,14027,15.5,45097,83.2,5.7
47017,22138,14433,13659,42.6,28092,18.3,40392,79,4.5
47019,45701,28815,27687,44.9,56502,21.5,33382,81.3,3.7
47021,30818,20114,19766,41.2,39880,11.1,58555,85.6,4.2
47023,13636,9081,8372,37.8,17453,16,44567,84,6.3
47025,25626,16220,15537,43,31757,25.4,33437,77.2,4.1
47027,6200,3911,3841,47.1,7752,22,30976,76.3,3.6
47029,28031,18268,16951,45.1,35219,24.2,31965,78.8,5.4
47031,41528,27999,26683,39.9,54682,14.3,47884,85.4,4.1
47033,10956,7493,6918,40.4,14411,17.6,41447,76.5,3.8
47035,48093,29975,28680,50.8,58655,15.3,43504,83.6,4.1
47037,538433,354769,329641,34.3,684410,15.1,54666,87.5,4.3
47039,9258,5958,5811,45.6,11769,18.8,38246,82.3,4.4
47041,15106,9808,9553,42.3,19361,19.8,40869,78,3.7
47043,39981,26586,25584,40,52170,13.5,52144,83.6,3.3
47045,28626,19573,18135,39.7,37708,20,40163,83.2,4.8
47047,31623,20082,19508,45.5,39590,14.5,56724,86.2,4.9
47049,14184,9220,8813,45.3,18033,21.4,32352,77.3,4.1
47051,33163,21368,20332,42.3,41700,15.5,47562,85.3,4.7
47053,37362,25667,23734,40,49401,16.9,38605,84.8,4.6
47055,23136,15099,14208,43.8,29307,16.7,43238,83.3,3.9
47057,18284,11442,11630,44.6,23072,20,39752,80.4,4.3
47059,55117,34878,33737,44.8,68615,17,40855,81.9,4.3
47061,10482,6772,6617,43.3,13389,22.6,32453,74,5.1
47063,48970,32618,31167,40.9,63785,18.5,42047,81.5,4.8
47065,282494,185195,172543,39.6,357738,13.5,48690,87.8,4.3
47067,5213,3321,3256,44,6577,30.9,28228,75.7,5.9
47069,20414,11497,13938,40.2,25435,25.2,36653,77,8.5
47071,20396,13247,12432,45.3,25679,21.5,37039,79.6,6.4
47073,44889,28761,27802,44.7,56563,19.2,38958,82,4.6
47075,13764,9522,8331,41.4,17853,20,35672,80.8,4
47077,21401,14329,13493,40.8,27822,17.4,42821,80.2,5.2
47079,25632,16691,15619,45.6,32310,19.5,38721,84.3,4.2
47081,18945,11673,12622,41,24295,20.7,41406,77.2,4
47083,6368,4154,3980,43.6,8134,17.8,40777,76.9,3.7
47085,14327,9254,9093,43.4,18347,18.4,4.40E+04,83.2,4.2
47087,9434,5791,5775,47.2,11566,21.9,34117,76.6,4.9
47089,42741,27175,26360,43.8,53535,15.7,45490,83.7,4.5
47091,14691,8195,9559,45.5,17754,25.4,33639,76.3,2.7
47093,359341,234563,221569,37.5,456132,14.8,52174,90.6,4
47095,6445,2712,4848,39.4,7560,42.7,30078,73.1,3.8
47097,20696,12755,14018,37.8,26773,24.9,38479,75.5,5.4
47099,32235,21971,21110,39.6,43081,16.7,41370,79.9,4.8
47101,9284,6107,5797,43.5,11904,18.5,38074,82.6,2.6
47103,26176,17192,16453,43.3,33645,16.7,43464,83.3,4.3
47105,41366,26252,25202,47.8,51454,10.6,56774,85.3,3.8
47107,41520,27091,25759,43.1,52850,16.9,40897,83.2,4.5
47109,20211,13163,12772,43.3,25935,22,37574,80.7,7.5
47111,17677,12052,11398,38.9,23450,17.9,34203,75.7,3.9
47113,75343,51472,46191,38.5,97663,19,43037,88.5,4.3
47115,22427,14568,13878,43.5,28446,18.3,42348,78.3,3.5
47117,24415,16243,15672,40.1,31915,13.2,50014,84,5.1
47119,68906,46628,43353,38.8,89981,11.5,51202,88.2,4.4
47121,9472,6017,5988,44.5,12005,18.3,40238,78.9,5.9
47123,35947,23170,22800,43.8,45970,19.3,38265,79.1,5.8
47125,143111,97875,97859,30.7,195734,12.9,55351,92.2,4.7
47127,5081,3160,3163,45.3,6323,10.9,54922,86.1,3.3
47129,17255,9825,11729,41.8,21554,22.7,38069,79.8,3.6
47131,23901,15784,14794,42.9,30578,18.6,37437,82.9,6
47133,17256,11181,10870,43.4,22051,18.7,35273,78.4,3.8
47135,6221,3941,4023,43.8,7964,22.1,35140,75.2,3.3
47137,4189,2581,2561,49.8,5142,17,36595,77.3,3.1
47139,13419,8424,8348,44.8,16772,16.2,41984,79,4.7
47141,59901,38220,37711,36.3,75931,19.2,40479,85.2,4.3
47143,24982,16434,16008,41.1,32442,18.2,42137,75.9,4.6
47145,42743,26996,25878,46.9,52874,14.2,47088,85.8,4.8
47147,52193,35104,34061,38.8,69165,10.3,58487,86.5,4.9
47149,231502,156503,151748,33.6,308251,10.3,61232,90.8,4.3
47151,16572,11097,10850,39.4,21947,22,34196,77.3,7.1
47153,11693,7528,7369,43.8,14897,17.7,43367,81.8,4.8
47155,76400,49212,47461,43.1,96673,15.1,45251,83.5,4
47157,698803,489831,444772,35.4,934603,20.8,47639,87.1,6.1
47159,14915,9775,9672,40.9,19447,14.6,46977,82.7,2.4
47161,10442,6571,6611,44.8,13182,16.4,44605,86.3,4.3
47163,125882,80670,75997,45,156667,16.4,43211,85.7,4.3
47165,136846,91985,88078,39.6,180063,9.7,61134,89.3,3.5
47167,45984,31075,30228,38,61303,16.1,54748,85.7,5.9
47169,6369,4180,4091,39.9,8271,15.3,44971,79.3,4.8
47171,14409,9.00E+03,8719,46.9,17719,17.3,39755,80.9,5.9
47173,14877,9682,9458,42.3,19140,22.2,37955,76.9,4.4
47175,4592,2818,2871,46.7,5689,19.1,38123,80.5,6.2
47177,30880,20496,20020,40.4,40516,19.4,37682,78.6,4.5
47179,102752,65098,62342,40.3,127440,14.8,46316,88.4,3.4
47181,13784,7513,9200,42.8,16713,20.9,37672,78.5,3.9
47183,26954,17184,16323,38,33507,20.8,38214,84.8,5.6
47185,20802,13566,13087,42.9,26653,17.7,39818,82.2,5.3
47187,158559,111997,107110,39.1,219107,5.2,107942,95.6,2.6
47189,100980,67701,65080,40,132781,8.1,70955,89.8,3.5
48001,46484,22439,35295,39.1,57734,20.5,43967,80.2,1.9
48003,12241,8708,9052,31.4,17760,11.7,60644,73.8,3.5
48005,65101,44887,42904,37.1,87791,19,43658,79.9,4.8
48007,20980,12976,12745,49.5,25721,18.8,44866,83.2,3.9
48009,6812,4371,4332,44.1,8703,10.5,58928,90.1,2.1
48011,1437,934,942,44.2,1876,10.8,54868,89.8,1
48013,35342,24581,24216,35.4,48797,16.3,53622,75.3,4.4
48015,22541,15091,14667,41.2,29758,14.3,55973,82.4,3.6
48017,4870,3558,3623,32.7,7181,16.6,40536,67.6,1.3
48019,18135,11019,10757,52.4,21776,14.6,55885,86.8,2.1
48021,61493,40685,42048,38.3,82733,13.2,56449,80.6,5.1
48023,2903,1887,1810,46.4,3697,17.6,36616,86.9,0.7
48025,25620,12985,19765,34.7,32750,27,40753,71.4,2.5
48027,245293,170833,169578,30.9,340411,12.9,51993,90.3,5
48029,1427987,977727,950953,33.5,1928680,16.3,53170,83.4,4.3
48031,9277,5696,5696,49.6,11392,10.7,57634,89.9,3.4
48033,489,310,323,44.2,633,10.6,60306,93.3,0.6
48035,14196,9198,8899,46.7,18097,15.8,47636,82.3,3.4
48037,71546,46697,47163,37.9,93860,19.3,45455,87.5,4.3
48039,259785,174972,179223,35.7,354195,9.9,74510,86.7,3.3
48041,175222,108722,111695,26,220417,24.9,42279,85.6,3.6
48043,7405,4574,4626,42.7,9200,14.9,43055,86.4,4.4
48045,1172,748,726,46.8,1474,15.4,43376,77.5,3.5
48047,5197,3564,3650,35.1,7214,32.2,27703,70.4,6.9
48049,29547,19429,18842,40.6,38271,17.1,43770,85.1,2.2
48051,13717,8934,8826,44,17760,14.4,48533,80.4,3.5
48053,36269,23573,22670,44.5,46243,11.5,55919,86.1,2.6
48055,31391,20389,20772,36.1,41161,16.6,49598,79.1,2.6
48057,16471,10731,11234,37.9,21965,15.7,52916,80.5,3.9
48059,10658,7004,6816,43.2,13820,14.9,45727,88,1.9
48061,290957,217529,204606,31.8,422135,29.1,36587,65.6,5.2
48063,9470,6608,6259,38,12867,19.2,41937,81.2,3.8
48065,4521,3026,3031,39.2,6057,8.6,62573,92.2,1.4
48067,23512,15683,14692,44.2,30375,17.4,40597,85.9,4.8
48069,5422,3767,3902,34.9,7669,18.1,45229,70.5,2.9
48071,28841,19738,20161,35.3,39899,9.2,80279,83.8,3.8
48073,38406,25272,26396,37.8,51668,19.4,39407,79.6,3.2
48075,5592,2901,4151,33.8,7052,21.5,39140,85.3,2.9
48077,8082,5099,5094,46.5,10193,13.3,49171,89.3,3.9
48079,2069,1440,1442,34.7,2882,23.5,39900,70,4.1
48081,2578,1657,1607,48.8,3264,15.6,41529,85.3,2.6
48083,6593,4199,4221,47.1,8420,20.1,42258,82.6,3.1
48085,689224,478208,461377,36.7,939585,6.3,90382,93.6,3.2
48087,2196,1552,1464,36.8,3016,19.7,37389,77,3
48089,16179,10481,10538,43.6,21019,14.5,48161,81.8,1.9
48091,104063,68292,66496,42.4,134788,8.6,76296,91.5,2.7
48093,10471,6827,6657,45.5,13484,17.1,40052,79.9,2.7
48095,3711,1263,3016,40.9,4279,25.8,39622,61.4,0.6
48097,29841,19710,19556,40.1,39266,13.8,59243,86.1,4.2
48099,56965,37713,36973,31.8,74686,14.2,50122,87.6,4
48101,1076,721,681,45.1,1402,21.4,34605,72.2,6.9
48103,3398,2419,2411,33.6,4830,10.3,57408,72.8,2
48105,2737,1811,1864,39,3675,16.9,46556,73.7,1.6
48107,4356,3041,2951,37.5,5992,24.1,35136,72.3,5.8
48109,1663,1112,1086,40,2198,23.6,36663,64.9,2.8
48111,4806,3433,3623,30.9,7056,11.3,48470,72.7,3.5
48113,1887435,1307558,1267426,33.4,2574984,16.3,54429,78,4.6
48115,9708,5968,7143,33.7,13111,21.4,41073,74.1,3.7
48117,12913,9461,9369,31.6,18830,17.1,43944,71.8,3.2
48119,4044,2647,2568,44.4,5215,18.5,41266,86.3,4.8
48121,600458,409797,396383,35.1,806180,8.2,80841,92,3.7
48123,16106,9923,10942,41.6,20865,18.2,46915,79.9,3.4
48125,1765,937,1247,42.3,2184,21.8,38239,78.5,5.4
48127,7568,5510,5284,33.4,10794,27.6,38275,66.6,7.3
48129,2704,1728,1677,41.9,3405,18.6,38777,87.3,2.6
48131,8481,5567,5861,36.2,11428,26.3,34777,67.1,5.9
48133,14400,9238,9036,42.2,18274,20,37789,82.8,2.4
48135,109943,77799,79663,30.5,157462,13.9,53474,75.1,4.4
48137,1502,904,1007,47.8,1911,23.3,36539,75.1,2.3
48139,123249,85466,83033,36,168499,9.7,69448,84.6,3.7
48141,605418,426178,411740,32.1,837918,22.7,42048,76.5,4.6
48143,33014,21095,20564,30.3,41659,19.5,43787,83.9,2.5
48145,13593,9045,8228,39,17273,25.6,38559,75.7,2.8
48147,26947,15979,18052,42.3,34031,16.1,46347,83,3.3
48149,19923,12805,12344,47.4,25149,11.1,53776,81.7,0.9
48151,3056,1929,1925,45.6,3854,15.6,46247,82.8,3.9
48153,4322,2969,2948,37.5,5917,22.8,40536,73.2,4.4
48155,955,619,564,48.8,1183,18,36056,80.8,5.1
48157,536203,376903,364334,36.1,741237,8.3,90972,89.2,3.6
48159,8028,5332,5275,42.8,10607,15.8,44202,85.5,3.8
48161,15083,9429,10195,41.5,19624,19.1,45681,81.1,2.8
48163,14317,7821,11135,31.4,18956,25.8,39193,62.8,3.5
48165,13167,10165,10313,28.4,20478,14.6,51910,60.4,2.8
48167,248549,167013,162418,37.5,329431,12.9,64155,87.6,4.6
48169,5307,2260,4182,33.6,6442,30,44210,57,1.2
48171,21343,13725,12796,51,26521,9.8,58787,89.3,3.3
48173,980,588,726,37.4,1314,8.7,71360,75.2,1.6
48175,5892,3793,3724,45.2,7517,14.3,55264,88.8,5.2
48177,15177,10322,10554,36.9,20876,17.1,45491,72.5,3.9
48179,16915,10658,12067,37.3,22725,19.4,47828,80.3,3
48181,97620,65523,62712,39.6,128235,13.2,51808,87.6,4.6
48183,91544,63279,60466,35.5,123745,17.4,45594,83.7,3.5
48185,21499,12591,15080,40.9,27671,16.7,50891,77.8,3
48187,115429,78610,76655,36.8,155265,9.8,67683,88.2,3.3
48189,24756,16510,17753,32.8,34263,21.6,40152,75.4,3.8
48191,2400,1601,1537,43.5,3138,25.8,30971,72.1,4.6
48193,6562,4167,4137,46.9,8304,15.1,45718,82.2,2.6
48195,3909,2728,2810,35.2,5538,13.4,57832,74,1.6
48197,2985,1946,1960,42.2,3906,17.8,35521,75.6,3.1
48199,42419,28486,27836,39,56322,10.8,60692,86.9,2.8
48201,3350806,2308057,2281871,33.3,4589928,16.6,56415,80.2,4.8
48203,49549,34057,32477,37.9,66534,17.4,47181,82.8,4.9
48205,4478,2367,3380,39.9,5747,9.6,70121,82.1,0.7
48207,4577,2680,3001,41.9,5681,24.5,34653,68.5,4.7
48209,157066,102759,101711,31.7,204470,12.4,64864,88.9,4.1
48211,2797,2100,2029,33.8,4129,10,74856,78.7,3
48213,62611,40948,38953,44.3,79901,16.8,43425,82.9,3.6
48215,566954,434569,415274,29.1,849843,31.2,35928,63.3,5.2
48217,26813,17638,17439,41.8,35077,16.2,47338,80.3,5.1
48219,17170,11709,11566,33.7,23275,17.1,46856,78.2,4.6
48221,44891,29071,27786,46.4,56857,10.3,57346,88.2,1.7
48223,27308,18562,17838,39.5,36400,15.3,46582,82.4,3.5
48225,18347,10654,12100,44.5,22754,22.1,34587,82.4,2.2
48227,28664,15731,20977,36.5,36708,17.9,51863,79.4,3.5
48229,3092,2008,2045,34.6,4053,21.4,35252,52.2,2.4
48231,70134,46609,45464,38.3,92073,16.3,51827,82.7,5.7
48233,15945,10670,10841,37.4,21511,13.1,53936,84.9,2.9
48235,1181,767,790,43.5,1557,8,67249,91.7,2.1
48237,6842,3821,4923,39,8744,17.2,46975,78.9,2.2
48239,11080,7490,7379,38.3,14869,13.5,53143,84.1,3.1
48241,27001,18032,17616,40.9,35648,19.2,44909,86.8,5.3
48243,1999,1086,1114,57.1,2200,13,46688,80.6,2.5
48245,193777,124140,130539,36.1,254679,20.1,46198,83.3,4.2
48247,3600,2572,2574,34.7,5146,27.9,33784,74.9,9
48249,29450,20902,20247,34.4,41149,23.2,40056,73.4,3.6
48251,120740,81771,81503,36.8,163274,11.3,59809,83.8,3.9
48253,16470,7387,12622,38.2,20009,21.3,40931,77.3,1.2
48255,12066,6248,9006,35.6,15254,21.8,47608,76.5,1.8
48257,85774,59986,58364,35.8,118350,11.4,62363,84.5,4.6
48259,32625,21803,20737,43.1,42540,7.4,83805,93,2.8
48261,287,202,202,36.8,404,16.2,38718,57.6,0
48263,615,393,376,51.1,769,11.5,45123,78.3,1.3
48265,41519,26670,24834,48.1,51504,14.8,50461,86.6,4.4
48267,3595,2239,2184,50.5,4423,19.4,40118,83.1,3.6
48269,207,148,141,39.5,289,10.7,59142,80.6,3.1
48271,2926,1599,1991,43.6,3590,20,40612,67.2,6.8
48273,23997,15544,16146,28.1,31690,22.9,44106,77.4,6.6
48275,2780,1927,1879,39.5,3806,21.1,37586,80.1,2.9
48277,37904,25774,24017,40.1,49791,19.9,41887,84.5,4
48279,9580,6710,6565,36.6,13275,21.5,37846,74.2,2.8
48281,15967,10529,10231,42.2,20760,13.6,52637,88.6,4.6
48283,6044,3098,4515,30.7,7613,26.2,39926,63.7,3.9
48285,15143,10088,9721,43.8,19809,12.5,48975,83,2.1
48287,13275,8470,8585,41.8,17055,12.7,51768,82.3,3.6
48289,13364,8661,8638,45.1,17299,18,44891,84.5,4.1
48291,60866,41358,40346,36,81704,15.9,48592,76.2,4.7
48293,18081,11381,12087,39.5,23468,21.1,39382,78.9,5
48295,2548,1672,1815,35.6,3487,12.4,54180,80.1,3.7
48297,9633,5527,6529,41.6,12056,17.2,51953,79.2,1.5
48299,17178,10537,9825,56.5,20362,13.4,48135,86.5,3.5
48301,68,51,62,28.8,113,13.3,64179,74.6,0
48303,230117,153579,149558,30.8,303137,18.9,48587,85.1,3.5
48305,4185,2787,2924,38.1,5711,17.9,39869,77.9,6.7
48307,6323,4078,4094,43.9,8172,18.4,40125,77.5,2.4
48309,186393,1.27E+05,120934,33,247934,18.5,46662,83.8,3.4
48311,626,392,412,44.3,804,12,67249,81.4,9.5
48313,10944,5992,7995,34.5,13987,17.3,42429,77.6,1.5
48315,8265,5251,4896,50,10147,22.6,34919,80.3,4.3
48317,3938,2856,2867,32,5723,13,58760,77.3,2.1
48319,3286,2041,2070,49.7,4111,13.2,44818,89.1,2.9
48321,27690,18589,18598,37.4,37187,17.4,46324,77.7,3.7
48323,39255,29101,28584,29.8,57685,24.3,35654,58.7,7.3
48325,37664,23764,25519,39.1,49283,14.4,51304,82.5,3.4
48327,1724,1062,1061,53.1,2123,21.4,34839,78.9,4.5
48329,116453,80837,81728,31.8,162565,9.7,68729,83.4,2.6
48331,18718,12614,12257,41.3,24871,16.3,42302,80.3,5.2
48333,3825,2487,2420,48,4907,15.8,43540,83.1,2.1
48335,6985,3498,5222,35.4,8720,21.6,41262,74.8,2.6
48337,14958,9880,9534,43.5,19414,16.5,46237,82.1,3.4
48339,408187,280735,275468,36.7,556203,10.9,72506,86.8,3.5
48341,15102,10619,11501,30.8,22120,11.8,52344,63.9,2.7
48343,9745,6560,6033,42.8,12593,20,38255,86.9,7
48345,945,547,613,51.7,1160,18.2,37464,88.4,5.9
48347,50293,34245,31561,30.7,65806,25.4,38099,81.2,5.3
48349,35772,24593,23930,38.1,48523,17.8,44111,76.8,6.2
48351,11076,6704,7299,42.3,14003,22.8,41388,86.7,6.4
48353,11097,7538,7455,37.6,14993,18.4,40969,80.1,3.7
48355,270764,183050,178300,35.1,361350,15.1,53562,81.3,3.9
48357,7005,5101,5205,31.7,10306,11.4,61194,75.9,3.2
48359,1532,993,1083,39.2,2076,14.3,54212,84.8,2.8
48361,63795,42940,42024,38.1,84964,14,53611,89.2,4.5
48363,21436,14268,13785,41.1,28053,16.4,43589,82.7,3.9
48365,17897,11874,11618,40,23492,15.6,47780,84.3,2.7
48367,97738,65032,64409,39.9,129441,9.3,67735,89.3,3.5
48369,6973,4705,5071,34.1,9776,15.5,48344,68.6,1.9
48371,11994,6899,9071,35.4,15970,17.1,45414,68.8,2.1
48373,38122,22289,25627,43.7,47916,20.3,43014,80.5,4.6
48375,87657,58537,62295,33.7,120832,22,41563,76.4,2.8
48377,5093,3466,3492,38.4,6958,24.1,32742,56.8,4.7
48379,9122,5669,5645,47.9,11314,14.8,47354,81.9,3.5
48381,100469,67375,65126,35.4,132501,9.1,65795,91.1,2.4
48383,2541,1710,1898,33.2,3608,11.8,67308,71.5,2.8
48385,2807,1695,1694,52.5,3389,18.4,36744,80.3,2.9
48387,9781,6266,5941,47,12207,17.1,36352,80.4,3.5
48389,11564,5866,9055,33.7,14921,25,40092,61,3.6
48391,5560,3728,3593,41.4,7321,15.7,45366,79.8,4.2
48393,697,453,463,40.3,916,6.6,75816,93.9,1.6
48395,12669,8490,8261,40,16751,18.7,42680,82.6,4.7
48397,68505,47692,46286,37.6,93978,5.2,97484,91.9,3.7
48399,8070,5147,5301,42.4,10448,17.2,40112,78.8,2.5
48401,40468,25043,27689,38.8,52732,15.6,46421,79.3,3.1
48403,8359,5192,5111,52.1,10303,17.5,38451,85.4,3.2
48405,6674,4244,4076,49.3,8320,23.8,36426,80.5,5.3
48407,21635,13847,13860,44.8,27707,17.7,45794,82.8,3.9
48409,49364,33777,33878,35.5,67655,15.8,51667,78.1,3.2
48411,4748,2737,3207,41.5,5944,20.1,39995,74.5,1.9
48413,2202,1507,1549,36.3,3056,16.6,47258,76.3,3.1
48415,12878,7996,9337,35.5,17333,15.2,50316,80.7,2.4
48417,2516,1698,1617,42.5,3315,14.8,55403,84.5,3
48419,18791,12836,12743,37.7,25579,21.1,37410,75.4,5.1
48421,2214,1485,1583,37.4,3068,13.1,55761,74.3,0.7
48423,169411,116492,108798,36.3,225290,15.7,52520,84.7,4
48425,6786,4506,4269,41.9,8775,10.8,56944,82.7,2
48427,42827,32928,31194,28.8,64122,39.9,26691,48.5,7.9
48429,7800,4490,5416,38.9,9906,21.4,42831,77.1,3.1
48431,988,667,700,37.3,1367,12.7,60577,85.8,0.9
48433,1099,751,675,46.9,1426,15.6,44225,79.5,4
48435,2910,1898,1971,40.5,3869,14.1,54760,76.6,4.2
48437,5579,3503,3963,36.4,7466,22.2,38790,80.5,2.5
48439,1477449,1029925,986947,34.4,2016872,13.6,61553,85.2,4.1
48441,102856,69603,66932,32.4,136535,16.8,48215,86.8,3.4
48443,652,404,408,46.6,812,18.7,41114,76.4,2.7
48445,9267,5993,6806,33.8,12799,21.8,38910,69.2,3.6
48447,1206,803,730,46.9,1533,14.9,42876,80.6,1.7
48449,23136,16540,16052,34.1,32592,14.9,45324,72.1,4.1
48451,90373,59526,58860,33.9,118386,13.4,48221,83.3,2.3
48453,929033,594846,604477,33.9,1199323,12.2,70068,88.2,3.7
48455,11560,7448,6994,48.2,14442,20.1,38973,83.7,4.6
48457,17183,9817,11503,42.3,21320,18.4,43617,84.4,4.5
48459,31199,20617,20352,40.6,40969,15.4,49015,83.4,4.4
48461,2601,1779,1894,34.1,3673,13.6,56335,75.4,2.5
48463,19757,13837,13448,34.2,27285,25.3,36913,69.3,3.8
48465,34852,23930,24951,31.8,48881,20.7,42104,66.9,4.6
48467,41762,27726,26629,43.1,54355,14.8,49751,82.3,3.3
48469,68654,47070,45397,35.5,92467,14.2,53659,83.6,3.5
48471,60474,29817,41667,35.1,71484,22.3,42709,82.6,1.6
48473,38045,25204,24911,29,50115,16.5,56407,78.4,5.5
48475,8308,5794,5806,34.4,11600,12.8,63809,77,3
48477,27531,17837,17219,42,35056,14.1,53157,82.6,2.7
48479,179650,138609,132584,28.4,271193,31.8,36718,65.7,3.4
48481,30923,21280,20455,37.3,41735,17.4,46097,78,3.5
48483,4098,2774,2772,39.2,5546,13.4,47476,80.3,3.4
48485,102221,63653,68185,34.3,131838,16.8,45071,86,2.9
48487,9926,6488,6404,38.6,12892,15.8,40955,78,4
48489,16519,9801,12009,32.8,21810,38.3,31225,63.1,5.5
48491,389356,268805,259913,36.1,528718,5.8,82370,92.9,3.7
48493,36673,24183,24297,40.2,48480,10.4,66045,84.9,3.8
48495,5508,3841,4052,32.3,7893,15,53312,68.1,2.5
48497,48358,32158,32297,38.7,64455,12,57609,84.6,4
48499,35618,22201,22026,48.4,44227,13.2,47260,85.1,4.5
48501,5713,4221,4267,31.1,8488,12.2,57114,71.4,6.2
48503,13734,9191,8961,41.3,18152,14.6,52133,81.6,2.5
48505,9526,7198,7151,29.3,14349,29.1,34136,50.3,7.6
48507,8400,5986,6037,30.5,12023,34.4,25507,59.2,6.5
49001,4419,3121,3342,33.6,6463,8.9,49843,91.3,2.3
49003,36035,26291,26848,32.7,53139,9.5,57875,93,3.8
49005,85080,61213,61540,25.1,122753,12.8,57422,93,3.1
49007,14971,10256,10143,36.3,20399,15.2,49743,87.9,4.7
49009,857,454,641,44.2,1095,8.2,54784,95.1,2.4
49011,230106,169692,172589,30.8,342281,6.3,77095,95.5,2.5
49013,13270,10083,10254,30.7,20337,13.8,56408,87.3,3.6
49015,7174,5032,5184,36.1,10216,12.4,54569,92,2.5
49017,3774,2365,2621,41.6,4986,10.9,47901,90.7,3.5
49019,7458,4766,4813,41,9579,12.7,55916,91.5,5
49021,35432,24919,25018,28.9,49937,18.4,45581,92.1,5
49023,7177,5332,5678,30.6,11010,10.6,57820,92.1,2.7
49025,5677,3614,3720,43.3,7334,10.6,48697,95,3.8
49027,8765,6228,6466,35.2,12694,11.2,55656,89.7,2.5
49029,7349,5549,5888,31.7,11437,4.3,85681,97.9,2.3
49031,1107,727,739,46.7,1466,17.7,39659,83,1.6
49033,1632,1136,1183,37.6,2319,9.3,60008,96.1,2.6
49035,808314,558469,562885,32.6,1121354,9.4,68404,89.8,3.6
49037,11423,8481,8414,30.5,16895,31,42747,84.2,4.2
49039,21627,14030,15379,31.4,29409,16.8,47768,89.2,4.2
49041,14940,10455,10812,35.5,21267,13.8,50909,89.4,3.2
49043,30037,19707,20600,38.8,40307,6,94540,94.2,2.3
49045,43146,3.20E+04,32833,31.5,64833,8.1,64675,91.6,4.8
49047,24038,17895,18478,30.5,36373,11.4,64184,86.8,3.5
49049,389800,292979,299320,24.6,592299,11.4,69568,93.6,3.3
49051,20666,14931,15597,33.3,30528,5.5,73077,92.3,2.5
49053,116835,80989,79256,36.9,160245,12.5,54876,92.8,3.5
49055,2021,1320,1382,41.7,2702,14.8,43080,92.1,1.2
49057,176314,123289,124271,32.7,247560,10.8,62768,90.1,3.5
50001,30527,18471,18488,43.4,36959,9.7,59731,92.5,3.3
50003,29248,18577,17614,46.8,36191,13.9,51989,90.6,3.4
50005,24371,15201,15132,44.3,30333,13.5,48747,90.6,3.9
50007,131993,82402,79129,36.2,161531,9.6,67833,93.9,3.2
50009,5047,3058,3118,49.9,6176,15.7,40813,84.3,4.1
50011,37755,24579,24336,40.6,48915,10.5,59418,89.7,3.5
50013,5614,3452,3467,47.3,6919,8.8,65601,93.7,4.1
50015,20054,12660,12673,40.8,25333,12.1,56207,91.8,2.7
50017,23468,14459,14460,45.7,28919,10.6,54272,91.7,2.9
50019,21624,13339,13524,45.6,26863,15.5,43107,87.1,3
50021,48611,30075,29235,46.5,59310,13.3,50569,90.9,3.5
50023,47222,29544,28960,43.6,58504,10.8,55803,93.6,3.1
50025,35248,21958,21187,46.8,43145,12.7,47074,91.5,3.9
50027,45284,28353,27143,47.6,55496,10,58123,92.4,2.9
51001,26150,16898,16049,46.3,32947,20,39040,80.5,4
51003,85160,55785,51093,39.2,106878,8.5,73132,91.4,2
51005,12644,7971,7624,48.1,15595,14.9,47037,84.5,2.3
51007,10202,6580,6333,45.3,12913,10.4,56172,81.3,2.4
51009,25364,16391,15242,44.8,31633,14.3,46497,82.7,3.2
51011,12095,7974,7501,43.2,15475,13.9,51431,83.6,2.5
51013,189263,115176,114874,34.6,230050,7.5,108635,93.8,2.6
51015,60352,36893,38104,45,74997,9.2,56784,86.5,2.9
51017,3767,2212,2264,50.6,4476,11.7,47059,87.3,5.6
51019,62249,39453,38507,46.3,77960,9.6,55708,88.9,2.9
51021,5459,2916,3597,45.9,6513,13.8,44827,89.2,3.2
51023,26784,16780,16451,47.4,33231,7.8,68390,91.6,2.5
51025,13457,7715,8528,44.3,16243,22.8,39433,77.3,3.4
51027,18243,10891,11287,46.2,22178,25.1,31763,70,3.7
51029,13876,7693,9355,42.9,17048,17.6,42455,77.5,4.5
51031,44028,28302,26650,43.1,54952,13.3,49935,85.4,2.6
51033,23111,15402,14776,39.5,30178,9.9,55423,83.4,4.3
51035,23929,14924,14607,47.3,29531,16.3,40390,80.4,2.9
51036,5972,3642,3429,50.5,7071,12.4,56907,77.3,4.3
51037,9505,6077,6052,45.1,12129,20.8,38557,80,3.8
51041,257602,175607,163402,38.9,339009,7,76260,91.4,4.4
51043,11376,7246,7128,46.9,14374,7.9,76753,87.4,3
51045,4185,2576,2582,47.6,5158,12.6,48221,87.1,2.8
51047,37538,25004,25079,39,50083,9.8,67023,83.6,4.1
51049,7721,4997,4655,45.3,9652,18.2,42692,79.4,5.4
51051,11995,7359,7609,44.1,14968,25.6,32795,73.8,3.1
51053,22501,14458,13686,42.8,28144,13,54805,81.1,5.8
51057,8928,5875,5248,46.2,11123,13.1,50033,82.1,3.9
51059,867631,574592,564060,38,1138652,6,115518,91.7,3.3
51061,52875,34896,34173,42,69069,5.8,91372,91.5,2.7
51063,12557,7795,7936,46.5,15731,13.7,42670,83.5,4.2
51065,20875,14179,12092,43.6,26271,7.5,70005,89.3,3.2
51067,45213,28354,27715,46.8,56069,13.2,52424,85.4,3.7
51069,64944,42416,42005,40.7,84421,6.8,69346,88.1,3.4
51071,13357,8585,8272,44.5,16857,12.2,51780,85.2,2.7
51073,29621,18848,18366,44.3,37214,9.4,64296,89.8,2.5
51075,18426,11492,11176,47.8,22668,6.4,88815,90.6,3.1
51077,12365,7675,7432,48.8,15107,17.4,36113,79.2,3.7
51079,14711,9850,9521,40.9,19371,8.4,66170,83.5,5.1
51081,9753,4457,7249,41.4,11706,25.4,41539,76.6,2.9
51083,27813,18216,16776,46.1,34992,18.7,39859,79,2.9
51085,81148,53239,51153,42.7,104392,5.8,83405,92.6,2.6
51087,250825,172174,154327,38.3,326501,9.2,66524,90.9,4.4
51089,41205,26631,24814,46.9,51445,18.4,36703,79.2,5
51091,1911,1101,1115,56.7,2216,13.3,42837,84.1,0.7
51093,28892,18709,17887,44.7,36596,9.5,70982,86.6,5.2
51095,59363,38537,35867,46.4,74404,6.5,84035,93.9,2.8
51097,5832,3543,3616,47.7,7159,13.4,52115,85.5,3.4
51099,19379,12856,13128,37.6,25984,6.8,80664,92.8,4.4
51101,12555,8350,7984,40.4,16334,7.7,68053,88.3,2.6
51103,9324,5801,5171,57.4,10972,14,44941,89.3,2.7
51105,19645,11594,12585,44.1,24179,29.9,32466,75.4,5.3
51107,275089,195076,190869,36.1,385945,3.5,134609,93.5,3
51109,27947,17821,17415,44.9,35236,12.2,52671,83.6,5
51111,9984,5774,6499,45.2,12273,19.8,38313,75.8,2.9
51113,10428,6744,6334,46.2,13078,11.2,56774,85.8,3.1
51115,7372,4539,4243,53.1,8782,10.1,59439,91.5,1.1
51117,25054,15946,14946,48.4,30892,15.9,45827,79.9,3.2
51119,9074,5497,5281,53.8,10778,14.2,49840,88.6,2.6
51121,82780,47173,51429,28.6,98602,20.3,51428,91.3,2.7
51125,12066,7621,7248,49.8,14869,12.6,54188,86.4,2.2
51127,16801,10337,10810,43.5,21147,5.9,84486,91.8,3.2
51131,9684,6291,5848,48.8,12139,20.3,39348,79.3,3.6
51133,10365,6195,6027,56.6,12222,13.4,52957,89.7,3.8
51135,12556,7143,8452,42.4,15595,22.9,40514,74.9,4
51137,27883,18146,17387,43.8,35533,9.2,64656,89.4,4.7
51139,18937,11961,11693,45.3,23654,16.4,45834,79.2,5.1
51141,14742,9098,8825,49.6,17923,17.9,38539,79.7,4
51143,49664,31344,30343,46.6,61687,13.6,46192,82.2,3.8
51145,23112,13573,14870,45.3,28443,6.6,78047,90.6,2.7
51147,19412,11626,11516,31.6,23142,22.6,41072,83.1,3.3
51149,29622,17323,20522,37.3,37845,9.5,66775,88.5,4.9
51153,329347,228361,226849,34.9,455210,7.4,97549,89,3.9
51155,27998,17059,17144,46.2,34203,14.4,49554,84.1,3.9
51157,6081,3737,3651,50.9,7388,9.9,65278,87.2,1.4
51159,7293,3931,4843,44.6,8774,19.3,45403,80.6,2.8
51161,74871,48840,45191,44.4,94031,7.4,62306,91.6,3
51163,18459,11302,11090,48.9,22392,12.3,50570,86.2,2.7
51165,62083,40506,39238,41.4,79744,9.7,57655,82,3.3
51167,22059,13958,13412,45.4,27370,16.9,39003,78.2,3.2
51169,17924,10911,11019,46.6,21930,19.5,38612,79.3,3.8
51171,33977,22042,21133,44.5,43175,10.8,53810,85.7,3.4
51173,24995,15805,15257,45,31062,18.1,40140,82.6,3.9
51175,14573,8654,9403,46.8,18057,15.6,49595,82.6,3.2
51177,98763,67140,64870,37.9,132010,7.4,81065,89.6,3.8
51179,106560,71636,72725,35.5,144361,5.7,97607,93.5,3.2
51181,5393,3350,3194,49.2,6544,13.4,51810,83.6,5
51183,9661,4706,6798,40.8,11504,23.1,41790,72.3,1.9
51185,33951,21120,21030,44.6,42150,18,38992,78.8,4.1
51187,30354,19604,19551,40.5,39155,10.3,65434,85.9,4.2
51191,43974,27540,26674,45.8,54214,14.7,44785,84.1,3.7
51193,14280,9032,8560,48.1,17592,14.8,48983,85,3.7
51195,31367,18799,20429,40.7,39228,23.5,33810,75.2,4.8
51197,23163,14819,14197,45,29016,14.4,47676,82.2,4.3
51199,51388,34611,33365,38.7,67976,5.1,87910,93.8,3.7
51510,127326,80643,75167,36.5,155810,10.5,87822,91.4,3.1
51515,,,,,,,,,
51520,13590,8906,8054,42.9,16960,23.6,33659,83.6,5.1
51530,5158,3443,3009,38.4,6452,16.2,38991,81.2,3.5
51540,39362,24190,22722,30.8,46912,22.8,47977,90.3,2.5
51550,180367,121794,116146,36.9,237940,8.6,71998,91.4,4
51570,13744,9556,8216,40.9,17772,10.4,52673,89,5.1
51580,4463,2823,2695,44.7,5518,15.9,37904,84.9,2.7
51590,32579,22514,19384,41.7,41898,22.3,35220,79.8,6.6
51595,4038,2888,2417,40,5305,23.2,33499,76.9,10.2
51600,18721,12250,11914,38.9,24164,6.8,94701,91.8,3.8
51610,10163,7130,6884,37.9,14014,3.6,118035,98,4.1
51620,6336,4534,3772,40.9,8306,18.2,40247,81.2,9.1
51630,22352,15333,12964,30,28297,14.6,53714,91.3,4.9
51640,5252,3635,3140,42.9,6775,20.5,35221,76.6,3.7
51650,106438,70332,65078,35.9,135410,16.4,50294,90.1,5.4
51660,44484,27635,25443,25.6,53078,28.4,41636,85.1,3.5
51670,16825,12166,10569,36,22735,20.7,40126,80.9,6.6
51678,6382,3060,3985,22.7,7045,22.2,45331,85,1.4
51680,64742,42625,37587,28.3,80212,17.8,41586,88.2,4.2
51683,30456,20816,20667,34.2,41483,9.7,72396,81.5,4.5
51685,11820,7784,8131,34.4,15915,7.8,75994,82.5,3.3
51690,10319,7270,6175,43.3,13445,23.2,34262,79.1,5.5
51700,139616,93430,88395,33.2,181825,14.7,50149,89.2,5.2
51710,196030,117196,127919,30.5,245115,21.3,45809,87.5,5.5
51720,3064,2012,1852,39.7,3864,23,30587,82.8,8.4
51730,25013,17156,14726,38,31882,25.2,34238,78.7,7.9
51735,9433,6073,5944,43.9,12017,5.4,90119,94.8,2.1
51740,72862,49500,45752,35.2,95252,18.2,46617,84.9,6.7
51750,15200,9142,8341,24,17483,27.2,35655,89.6,4.7
51760,183066,117253,105917,33.4,223170,26.2,42336,84,5.9
51770,77517,51956,47704,38.4,99660,22.3,38238,85.2,4.7
51775,20560,13389,12160,40.3,25549,9.2,57897,89.5,3.1
51790,19864,13266,11097,42.9,24363,12.8,46237,88.2,3
51800,67173,46101,43172,37.8,89273,11.7,65025,88,4.7
51810,350853,230269,222333,35.8,452602,8.3,70596,93.2,3.7
51820,16840,11377,10510,39.1,21887,14.6,41255,86.3,3.2
51830,13539,8225,6989,26.8,15214,21.1,49231,94.7,4.5
51840,21376,13944,13572,37,27516,15,46093,83.5,3.2
53001,12368,9445,9793,28.2,19238,19.5,48698,66.1,3.9
53003,17664,11426,10880,45,22306,14.6,46121,90,4.8
53005,141809,96584,97102,35.7,193686,10.5,63474,89.6,4.1
53007,58131,38260,38078,39.7,76338,11.5,51930,82.6,4.2
53009,61628,37709,36861,51,74570,15.3,49502,91.9,4.6
53011,351953,236099,230919,38.2,467018,9,68937,91.7,4.6
53013,3237,2001,1937,51.6,3938,14,47894,89.9,4.7
53015,81329,53088,52072,41.6,105160,16.3,51772,88,5.4
53017,30540,20476,20851,37.5,41327,12.8,52363,81.1,3.2
53019,6288,3675,3939,50,7614,21.3,40581,87.5,4.2
53021,60289,43648,46512,29.8,90160,14.9,56940,73.6,4.4
53023,1797,1138,1109,49.9,2247,13.9,51922,96.4,2.4
53025,65644,46341,47205,32.7,93546,16.1,48997,75.1,5.6
53027,56754,34888,36740,43.9,71628,15.2,48210,88.2,6.3
53029,67482,41416,41220,44.4,82636,9.4,64475,94.8,4
53031,27209,15826,15313,58,31139,12,53345,94.5,3.4
53033,1706343,1074382,1075588,37.1,2149970,9.3,85907,92.5,3.8
53035,210153,129602,135209,39,264811,10.1,68706,94.3,3.9
53037,37090,22266,22600,33.5,44866,18.2,50410,90.6,4
53039,17120,10533,10768,47.1,21301,15.5,50691,86.5,2.6
53041,60403,38484,38582,43.2,77066,14.7,47127,87.1,5.2
53043,8135,5112,5238,48.6,10350,12.5,53886,91.3,2.1
53045,50315,30085,32113,46.2,62198,14.9,52758,87.4,5.4
53047,31985,20680,20874,43.4,41554,19.7,41726,82.3,4.5
53049,17725,10623,10626,53,21249,17,43168,88.4,3.4
53051,10606,6450,6673,50.6,13123,16.2,48706,89.2,4
53053,656881,433080,428232,36.1,861312,12.1,64312,91,4.9
53055,14137,8419,7920,56.3,16339,9.9,59658,95.3,2.9
53057,96486,62512,61169,41.7,123681,11.3,60442,88.9,4.3
53059,9253,5649,5861,46.5,11510,13.5,55802,90.5,4.3
53061,608025,392495,395125,38,787620,8,78582,91.8,4.1
53063,388177,251526,247546,37.4,499072,13.3,52933,93.1,4.3
53065,34686,22292,22147,46.8,44439,14.3,51303,89.9,4.5
53067,215448,140638,134584,39,275222,10.4,65684,93.6,5.1
53069,3405,2048,2091,54.2,4139,12.8,54162,93.1,2.7
53071,47421,29556,30784,37.5,60340,14.2,53598,88.6,3.7
53073,174146,109339,107461,37.1,216800,15.2,56636,91.2,4.8
53075,41392,24002,24849,24.8,48851,25.9,42693,95.8,5.2
53077,175048,124807,124829,32.8,249636,18.2,48232,72.5,5.2
54001,13431,8613,8218,41.5,16831,22.4,36485,81.1,4.1
54003,86367,57300,56225,38.4,113525,12.9,56966,87.2,5.8
54005,17843,11494,11322,43.1,22816,24.2,36313,79.2,4
54007,11589,7153,7318,45.3,14471,21.3,36612,81,7.6
54009,18932,11690,11287,46.4,22977,13.4,46020,90.1,2.3
54011,76774,48958,47029,38,95987,21.9,39462,87,3.6
54013,5938,3688,3648,47.7,7336,21.8,33818,76.9,7.9
54015,6865,4389,4470,44.1,8859,29,33706,72,4.6
54017,6902,3735,4678,43.2,8413,19.7,40524,78.3,2.7
54019,35166,22009,22314,43.7,44323,19.7,38829,81.7,4.1
54021,7070,3349,4900,38.4,8249,27.1,35325,80.5,4.3
54023,9442,5875,5857,46.9,11732,15,38477,81.7,3.2
54025,28387,18084,17195,46,35279,16,38784,83.8,4
54027,18673,11451,11850,46.2,23301,15.7,45172,80,3.8
54029,23858,15113,14477,46.1,29590,13.2,44889,87.2,3.9
54031,11098,6912,6977,45.3,13889,15.2,40243,80.3,4
54033,53607,34882,33518,42.2,68400,14.6,46548,87.7,4.2
54035,22859,14690,14462,43.7,29152,15.7,43544,86.6,2.7
54037,43517,28425,27943,40.8,56368,10.1,71315,88.8,5
54039,148497,96480,89761,43,186241,16.8,44956,88,3.7
54041,12937,8179,8130,43.9,16309,18.4,36826,87.2,3.7
54043,16475,10652,10580,42.9,21232,24.2,32477,79.1,3.3
54045,26788,17108,16592,43.4,33700,24.4,35667,77.7,5.5
54047,15189,9759,9382,45.1,19141,36.3,24460,64.9,3.7
54049,45170,28652,27886,40.8,56538,17.6,45712,88.9,3.4
54051,25501,16057,15736,45.1,31793,17.5,42357,89.2,3.2
54053,21153,13881,12944,43.6,26825,17.9,42187,84.7,4.7
54055,47925,31582,28886,43,60468,20.2,36871,83,3.1
54057,21890,13786,13625,44,27411,15.6,45437,88.7,4.1
54059,19084,12485,12162,42.1,24647,28.2,30638,73.9,7
54061,87307,50723,53899,31.2,104622,18.5,49725,91.6,3.6
54063,10638,6727,6643,46.7,13370,17.3,38395,81.4,4.6
54065,14390,8847,8785,47.9,17632,11.9,59573,82.9,7
54067,20155,12811,12500,45,25311,21.4,37359,83.7,3.9
54069,34322,21997,20519,43.2,42516,15.8,43240,91.9,3.2
54071,5817,3484,3567,50.9,7051,16.2,39951,81,2
54073,6172,3503,4088,43.9,7591,14.3,47276,87.6,4.2
54075,7019,4125,4376,48.7,8501,18.3,35906,84.8,3
54077,27231,16369,17389,42.8,33758,17.4,44438,83.5,4.1
54079,43957,29021,27920,42.1,56941,10.8,56789,92,1.8
54081,60426,38158,38443,42,76601,17.4,42282,84.3,3.8
54083,23466,13999,15007,44.2,29006,18.7,38549,82.8,3.9
54085,7907,4924,4951,46.1,9875,18.2,42154,81.9,4.2
54087,11148,7180,7028,45.3,14208,22.1,35135,78.2,4.6
54089,10699,7057,5815,47.5,12872,24.7,31458,82.8,5
54091,13497,8294,8565,43.9,16859,16.4,44598,85.9,5
54093,5743,3417,3509,48.4,6926,15.8,42128,87.3,4.5
54095,7177,4500,4472,46.4,8972,16.1,42429,87.6,4.1
54097,19553,12437,12221,41.4,24658,20.2,40509,83.9,4.1
54099,31939,20818,19713,43.5,40531,21.5,40881,79.4,4.5
54101,6882,4355,4291,46.7,8646,30,30578,73.9,5.1
54103,12510,7919,7721,46,15640,19.5,42679,83.1,3.9
54105,4583,2849,2957,45.4,5806,18.1,37542,83.3,2.7
54107,67399,44185,41458,43,85643,17.2,46737,89.6,4.3
54109,17170,11029,10734,43.8,21763,23.9,36018,77.4,4.8
55001,17097,9334,10735,53.3,20069,13.9,42390,87.3,4.4
55003,12203,7782,7932,41.8,15714,14.5,41949,91.6,4.5
55005,35595,22586,22826,44.5,45412,11.3,49581,89.9,3.4
55007,12296,7283,7608,52.2,14891,12.4,50666,94.5,3.9
55009,197770,130944,129457,37.2,260401,9.8,58449,91.4,3.7
55011,10345,6406,6693,46,13099,10.5,52885,91.5,2.5
55013,12482,7480,7733,52.4,15213,13.8,48087,92.1,3.4
55015,37272,24671,24882,39.9,49553,5,72752,92.6,1.9
55017,49384,30587,33062,41.3,63649,11.5,54659,92.1,2.7
55019,24420,17105,17452,37.6,34557,13.8,48675,81.6,2.7
55021,44469,27898,29029,42.2,56927,8.2,62036,92.8,2.9
55023,12928,7852,8469,46,16321,14.2,46698,90.1,3.2
55025,420347,267407,263866,34.9,531273,10.9,70815,95.3,3.2
55027,70252,41562,46506,42.5,88068,9.8,56949,89,3.1
55029,23099,13969,13618,53.1,27587,8.3,56298,93.6,3.4
55031,34833,21687,21822,42,43509,13.6,50340,93.6,4.1
55033,35883,22180,22524,35.3,44704,12.5,52181,92.9,3.6
55035,81894,52208,50757,34.3,102965,13.1,52209,93.1,3.4
55037,3805,2147,2309,53.6,4456,12.3,47704,92.8,4.2
55039,79923,51975,50169,41.5,102144,7.7,58920,91.6,3.1
55041,7234,4484,4580,46.7,9064,15.9,42072,86.5,5.2
55043,41532,25042,27172,35.6,52214,16.7,47512,91.4,2.8
55045,28725,18673,18402,43,37075,8.2,60846,92.2,2.1
55047,14576,9334,9385,46.2,18719,11.6,50386,88.6,3.1
55049,18235,11803,11851,43.3,23654,8.8,58372,93.4,2.9
55051,4853,2833,2893,54.6,5726,14.4,41597,93.4,3.9
55053,16010,9540,11022,42.2,20562,11.1,51024,88.2,3.3
55055,66257,42346,42279,40.6,84625,9.3,60744,91.1,3.2
55057,21011,12312,13962,45,26274,14.4,47938,86.1,3.4
55059,128583,84976,83207,38,168183,13,59622,90,5.8
55061,15977,10035,10370,44.6,20405,7.6,61074,92.1,3.1
55063,94437,60476,57646,35.8,118122,13.3,55151,94.5,3.3
55065,12555,8320,8433,41,16753,11.7,56074,89.9,2.1
55067,15452,9518,9703,48.7,19221,14.2,44522,89.9,4.3
55069,22668,13837,14065,47.6,27902,10,54471,90.3,3.1
55071,63007,39848,39688,45.1,79536,9.2,53633,90.9,3.2
55073,104466,67415,68188,40.9,135603,10.4,56223,91.1,3.3
55075,32735,20184,20307,48.6,40491,12.4,44265,91.4,3.9
55077,12076,7442,7625,49.6,15067,12,50032,88.5,3.7
55078,3023,2276,2257,31,4533,27.2,36562,89.3,5.8
55079,720362,490848,460600,34.6,951448,19.8,47666,86.9,5.3
55081,34072,22570,23053,39.7,45623,12,56400,90.2,3.9
55083,29748,18313,19117,46.5,37430,9.1,58025,90.4,3.3
55085,29484,17793,17808,50.9,35601,9.6,50938,92,2.9
55087,140535,92471,92055,38,184526,8,61764,93.5,2.6
55089,69175,44906,43408,43.8,88314,5.4,85706,96.3,2.4
55091,5762,3622,3685,46.5,7307,11.5,53262,90.9,2.7
55093,32601,20766,20472,36.8,41238,8.1,70086,94.7,2
55095,34156,21498,21983,45.4,43481,9.9,53661,92.8,3.7
55097,56845,34994,35453,36.8,70447,11.5,55064,93.2,4.2
55099,11140,6641,6876,51.7,13517,11.1,46414,90.3,2.3
55101,149255,98699,96441,40,195140,13.6,56246,88.8,4.8
55103,13629,8668,8808,45.4,17476,13.4,50306,89.3,2.2
55105,123451,82029,79591,39.4,161620,12.9,51573,89.4,4.8
55107,11199,6967,7160,48.5,14127,13.8,43075,87.5,2.9
55109,65577,44078,43951,38.8,88029,5.6,75619,95.8,3
55111,49409,32071,31878,41.3,63949,10.1,57647,90.9,3.3
55113,13136,8060,8309,50,16369,15.2,44180,91.1,4.3
55115,32207,20510,20552,45.3,41062,11.9,50203,90.6,2.9
55117,89441,57379,58048,41.5,115427,7.1,55594,91.6,3.4
55119,15588,10071,10368,43.7,20439,11.8,50963,87.6,2.9
55121,22303,14600,15033,41,29633,8.2,53142,89.4,2.2
55123,22831,15371,15443,42.4,30814,16.5,51002,88.1,2.1
55125,17861,10576,10859,54,21435,12.6,45902,92.5,4.1
55127,80889,51540,51419,39.8,102959,11.2,58904,90.9,4.3
55129,12674,7911,7737,50.9,15648,12.7,46989,91.8,3
55131,104100,67465,66831,43,134296,5.6,74631,93.9,2.9
55133,311351,202736,195688,43.2,398424,5.2,82080,95.9,2.5
55135,40858,25581,25952,45.4,51533,10.7,52125,90.9,2.9
55137,19638,11412,12750,48.8,24162,14.3,47596,86.2,3.5
55139,134709,84313,85573,38.3,169886,11.7,57003,92.1,2.9
55141,57320,37066,36041,44.1,73107,9.8,52591,92.3,3.7
56001,31920,18184,20072,27,38256,17.3,47355,95.8,3.1
56003,8926,5966,6039,40.4,12005,11.4,49725,89.6,1.9
56005,35066,23494,25309,33.3,48803,8.4,79148,91.7,3.5
56007,11897,7201,8417,37.4,15618,12.1,59103,90.4,2.7
56009,10547,7005,7186,38.2,14191,9,71517,90.2,3.7
56011,5649,3677,3787,43.6,7464,8.3,60953,93.9,2.9
56013,29970,20066,20176,38.2,40242,16.8,49282,91.5,4.7
56015,10660,6398,6992,43.2,13390,14.6,47715,91.6,4.1
56017,3714,2318,2361,48.7,4679,13.6,46024,91.6,2.1
56019,6620,4203,4283,45.3,8486,8.8,56323,94.9,3
56021,75142,48346,49790,36.8,98136,10.1,61124,93.3,3.6
56023,13932,9360,9750,39.1,19110,8.6,63907,93.1,3.8
56025,61344,40151,40888,36.3,81039,10.4,60559,91.7,3.4
56027,2027,1348,1132,43.5,2480,14.3,45332,88.9,0.2
56029,23298,14735,14618,43.9,29353,11.1,60621,94.3,2.5
56031,6938,4254,4426,47.5,8680,12,54588,90.3,2.3
56033,23779,15019,15181,42.5,30200,9.2,53027,93.9,2.4
56035,7409,4549,5220,39.8,9769,6.7,72198,95.3,2
56037,32299,21278,22887,34.7,44165,9.8,74546,90.7,3.7
56039,18837,11225,11966,38.8,23191,7.3,84118,95.4,1.7
56041,14675,10268,10505,35.5,20773,10.6,64713,89.6,4.2
56043,6267,4091,4144,42.8,8235,13.1,49533,87.4,4.6
56045,5684,3423,3813,42.5,7236,10.7,56582,91.4,2.1